variant	original	nmm
AAAGGAGAAGAACTTTTCAC	AAAGGAGAAGAACTTTTCAC	0
CCAATTCTTGTTGAATTAGA	CCAATTCTTGTTGAATTAGA	0
GAATTAGATGGTGATGTTAA	GAATTAGATGGTGATGTTAA	0
AATTAGATGGTGATGTTAAT	AATTAGATGGTGATGTTAAT	0
GGGCACAAATTTTCTGTCCG	GGGCACAAATTTTCTGTCCG	0
CAAATTTTCTGTCCGTGGAG	CAAATTTTCTGTCCGTGGAG	0
AAATTTTCTGTCCGTGGAGA	AAATTTTCTGTCCGTGGAGA	0
TCTGTCCGTGGAGAGGGTGA	TCTGTCCGTGGAGAGGGTGA	0
GGTGAAGGTGATGCTACAAA	GGTGAAGGTGATGCTACAAA	0
CTTAAATTTATTTGCACTAC	CTTAAATTTATTTGCACTAC	0
CTGGAAAACTACCTGTTCCG	CTGGAAAACTACCTGTTCCG	0
CTTGTCACTACTCTGACCTA	CTTGTCACTACTCTGACCTA	0
TCAATGCTTTTCCCGTTATC	TCAATGCTTTTCCCGTTATC	0
GTTATCCGGATCACATGAAA	GTTATCCGGATCACATGAAA	0
TTCAAGAGTGCCATGCCCGA	TTCAAGAGTGCCATGCCCGA	0
CATGCCCGAAGGTTATGTAC	CATGCCCGAAGGTTATGTAC	0
ACTATATCTTTCAAAGATGA	ACTATATCTTTCAAAGATGA	0
CTATATCTTTCAAAGATGAC	CTATATCTTTCAAAGATGAC	0
CGTGCTGAAGTCAAGTTTGA	CGTGCTGAAGTCAAGTTTGA	0
TGTTAATCGTATCGAGTTAA	TGTTAATCGTATCGAGTTAA	0
GTTAATCGTATCGAGTTAAA	GTTAATCGTATCGAGTTAAA	0
GGTATTGATTTTAAAGAAGA	GGTATTGATTTTAAAGAAGA	0
AAAGAAGATGGAAACATTCT	AAAGAAGATGGAAACATTCT	0
CTCACACAATGTATACATCA	CTCACACAATGTATACATCA	0
ACGGCAGACAAACAAAAGAA	ACGGCAGACAAACAAAAGAA	0
ATTCGCCACAACGTTGAAGA	ATTCGCCACAACGTTGAAGA	0
TATCAACAAAATACTCCAAT	TATCAACAAAATACTCCAAT	0
CAAAATACTCCAATTGGCGA	CAAAATACTCCAATTGGCGA	0
CAACGAAAAGCGTGACCACA	CAACGAAAAGCGTGACCACA	0
CTTGAGTTTGTAACTGCTGC	CTTGAGTTTGTAACTGCTGC	0
TTGAGTTTGTAACTGCTGCT	TTGAGTTTGTAACTGCTGCT	0
ACTGCTGCTGGGATTACACA	ACTGCTGCTGGGATTACACA	0
TGCTGGGATTACACATGGCA	TGCTGGGATTACACATGGCA	0
CGGAACCATCCTCAACGTTT	CGGAACCATCTTCAACGTTG	2
GTCGCCAGCTAATGGTTGTC	GTCGACAGGTAATGGTTGTC	2
GCGTTCATGTACATCACCTT	GCGTTCCTGTACATAACCTT	2
TGGTTGTCTGGTAAAAGCAC	TGGTTGTCTGGTAAAAGGAC	1
GACGACAGGTAACGGTTGTC	GTCGACAGGTAATGGTTGTC	2
TTTCATATGATCCGGATAAC	TTTCATGTGATCCGGATAAC	1
AGTACTGCAAATAGATTTAA	AGTAGTGCAAATAAATTTAA	2
CAGATTGTGTCGACAGTTAA	CAGATTGTGTCGACAGGTAA	1
CAAACTCAAGAAGGAGCATG	CAAACTCAAGAAGGACCATG	1
ATAATGGTCTGGTAGTTGAC	ATAATGGTCTGCTAGTTGAA	2
AGGAGAGGGCCAGCGCCAAT	AGGACAGGGCCATCGCCAAT	2
GGTAATGGTTGTCTCGTTAA	GGTAATGGTTGTCTGGTAAA	2
CAGTAGTGCATATAAATTTA	CAGTAGTGCAAATAAATTTA	1
CATATGGTCACGCATTTCGT	CATGTGGTCACGCTTTTCGT	2
TAACTCGATAAGATTAACGA	TAACTCGATACGATTAACAA	2
CGTTACTGTAGATAACCTTC	CGTTCCTGTACATAACCTTC	2
CATCACTTTCACCCTCTCCA	CATCACCTTCACCCTCTCCA	1
TCATGCCGTCTCATGTGATC	TCATGCCGTTTCATGTGATC	1
TTTCGTTGGGATCTTTCGAA	TTTCGTTGGGATCTTTCGAA	0
TTTCGTTGGGATCTTTCGAA	TTTCGTTGGGATCTTTCGAA	0
TTTCGTTGGGATCTTTCGAA	TTTCGTTGGGATCTTTCGAA	0
TTTCGTTGGGATCTTTCGAA	TTTCGTTGGGATCTTTCGAA	0
CAAACTCAAGAAGGACCATG	CAAACTCAAGAAGGACCATG	0
CAAACTCAAGAAGGACCATG	CAAACTCAAGAAGGACCATG	0
CAAACTCAAGAAGGACCATG	CAAACTCAAGAAGGACCATG	0
CAAACTCAAGAAGGACCATG	CAAACTCAAGAAGGACCATG	0
CTGTACATGACCTTCGGGCA	CTGTACATAACCTTCGGGCA	1
CTAACTCGATACGATTAACA	TTAACTCGATACGATTAACA	1
TAGGAGTATTTTGTTGATAA	TTGGAGTATTTTGTTGATAA	1
GCGTTCCTGCACACAACCTT	GCGTTCCTGTACATAACCTT	2
CAGCAGTTATAAACTCAAGA	CAGCAGTTACAAACTCAAGA	1
ATGTGGTCACCCATTTCGTT	ATGTGGTCACGCTTTTCGTT	2
ATAATGGTCTGCTCGTTCAA	ATAATGGTCTGCTAGTTGAA	2
TTCAGAGTATTGACAAGTGT	GTCAGAGTAGTGACAAGTGT	2
AGCACAGAGCCATCGCCAAT	AGGACAGGGCCATCGCCAAT	2
CTAACTCAAGAGGGACCATG	CAAACTCAAGAAGGACCATG	2
TTAACTCGATACGATTAAGA	TTAACTCGATACGATTAACA	1
TTAACTCGATACGAGTAACA	TTAACTCGATACGATTAACA	1
TTAATTCGGTACGATTAACA	TTAACTCGATACGATTAACA	2
AGTCGTGCATATAAATTTAA	AGTAGTGCAAATAAATTTAA	2
ACAAGTGTTGGCCACCGAAC	ACAAGTGTTGGCCACGGAAC	1
GTTTCATGTGATCCGCAAAA	GTTTCATGTGATCCGGATAA	2
ATAAAGGTCTGCTAGTTGAA	ATAATGGTCTGCTAGTTGAA	1
CATGTGGTCACGATTTACGT	CATGTGGTCACGCTTTTCGT	2
TCATGCCGTATCATGTGATC	TCATGCCGTTTCATGTGATC	1
ATGTGGTCACGATTTTCGTT	ATGTGGTCACGCTTTTCGTT	1
AAAGGACATATTGTGTCGAC	AAAGGACAGATTGTGTCGAC	1
TGGTTGTCTGGTAATAGGAC	TGGTTGTCTGGTAAAAGGAC	1
TTGCATGTGATCCGGATAAC	TTTCATGTGATCCGGATAAC	1
CCTCACCCTCACCCTCTCCA	CATCACCTTCACCCTCTCCA	2
CAGATTGTGTCGACCCGTAA	CAGATTGTGTCGACAGGTAA	2
ACAAGTGTAGGCCACAGAAC	ACAAGTGTTGGCCACGGAAC	2
CAGATTGTGGCGACAGGTAA	CAGATTGTGTCGACAGGTAA	1
ACGTGGTCACGCTTTTCATT	ATGTGGTCACGCTTTTCGTT	2
ATAATAGTCTGCTAGTTGAA	ATAATGGTCTGCTAGTTGAA	1
CGTTCCTGATCATAACCTTC	CGTTCCTGTACATAACCTTC	2
TAACTCGATACGATTATCAA	TAACTCGATACGATTAACAA	1
GGAAAAGCATTGAACACCTT	GGAAAAGCATTGAACACCAT	1
TTAACTCGAAACGATTAACA	TTAACTCGATACGATTAACA	1
TTAATTCGATACGACTAACA	TTAACTCGATACGATTAACA	2
CGGAAACATCTTAAACGTTG	CGGAACCATCTTCAACGTTG	2
CATGTGCTCACGCGTTTCGT	CATGTGGTCACGCTTTTCGT	2
CTGTACCTAGCCTTCGGGCA	CTGTACATAACCTTCGGGCA	2
CAAACTCAACAAGGACCTTG	CAAACTCAAGAAGGACCATG	2
CTGTACATTACCTTCGGGCA	CTGTACATAACCTTCGGGCA	1
GGTCATTGTTGTCTGGTAAA	GGTAATGGTTGTCTGGTAAA	2
ACAAGGGTTGGCCACGGAGC	ACAAGTGTTGGCCACGGAAC	2
AGGACCGGGCCATCGCTAAT	AGGACAGGGCCATCGCCAAT	2
GGAAAAGCATTGATCACCAT	GGAAAAGCATTGAACACCAT	1
ATGTCGTCACGCTTTTCGTT	ATGTGGTCACGCTTTTCGTT	1
ACAAGTGTTGGCCACCAAAC	ACAAGTGTTGGCCACGGAAC	2
TTGGAGTTTTTTGTTGATAA	TTGGAGTATTTTGTTGATAA	1
CAGCAGTTACAAACTCAAAA	CAGCAGTTACAAACTCAAGA	1
TTTCATGTGATCAGGATAAC	TTTCATGTGATCCGGATAAC	1
AGGAAAGGGCCAGCGCCAAT	AGGACAGGGCCATCGCCAAT	2
TTGGAGTCTTTTGTTGCTAA	TTGGAGTATTTTGTTGATAA	2
CATGTGGTCACGCCTTTCGT	CATGTGGTCACGCTTTTCGT	1
GTCGACCGGTAATGGTTGTC	GTCGACAGGTAATGGTTGTC	1
GGAAAAGCATTGAACAACAT	GGAAAAGCATTGAACACCAT	1
TGGTTGTCTCGTAAAAGGAC	TGGTTGTCTGGTAAAAGGAC	1
TTAACTCGATATGATTAAAA	TTAACTCGATACGATTAACA	2
CATCACCTTCCCCCTCTCCA	CATCACCTTCACCCTCTCCA	1
TTGTTGTCTGGCAAAAGGAC	TGGTTGTCTGGTAAAAGGAC	2
CCATCTAATGCAACAAGAAT	CCATCTAATTCAACAAGAAT	1
CATCACCTTCACCCCCTCCA	CATCACCTTCACCCTCTCCA	1
CAAACTCAAGAAGGACCACG	CAAACTCAAGAAGGACCATG	1
GGAAAAGAATTGAACACCAA	GGAAAAGCATTGAACACCAT	2
ACATCTAATTAAACAAGAAT	CCATCTAATTCAACAAGAAT	2
AACTTCAGCACTCGTCTTGT	GACTTCAGCACGCGTCTTGT	2
GACTTCAGAACGCCTCTTGT	GACTTCAGCACGCGTCTTGT	2
CTAGCGACAAGTGTTGGCCA	GTAGTGACAAGTGTTGGCCA	2
TTGGAGTATTTTGATGATAA	TTGGAGTATTTTGTTGATAA	1
AGGACATGGCCATCGGCAAT	AGGACAGGGCCATCGCCAAT	2
CATGTGGTCACGCTTTGCGT	CATGTGGTCACGCTTTTCGT	1
AGTAGTGCGAATAAATTTAA	AGTAGTGCAAATAAATTTAA	1
CAGTAGTACAAATAAATTTA	CAGTAGTGCAAATAAATTTA	1
AAAGGACAGATTGTGTCGAC	AAAGGACAGATTGTGTCGAC	0
AAAGGACAGATTGTGTCGAC	AAAGGACAGATTGTGTCGAC	0
AAAGGACAGATTGTGTCGAC	AAAGGACAGATTGTGTCGAC	0
AAAGGACAGATTGTGTCGAC	AAAGGACAGATTGTGTCGAC	0
CGGTACATAACCTTCGGGCC	CTGTACATAACCTTCGGGCA	2
GGTAACGGTTGTCTGGTGAA	GGTAATGGTTGTCTGGTAAA	2
GGTTGTCTGGTAAAATGACA	GGTTGTCTGGTAAAAGGACA	1
ATTCATGGGATCCGGATAAC	TTTCATGTGATCCGGATAAC	2
AAAGGAAAGATTGTGTCGAC	AAAGGACAGATTGTGTCGAC	1
TATCGCCTTCACCCTCTCCA	CATCACCTTCACCCTCTCCA	2
CATCACCTTCACCCTCTCGA	CATCACCTTCACCCTCTCCA	1
GGTTGTCTGGTTAAAGGACA	GGTTGTCTGGTAAAAGGACA	1
GTCGACAGGAAATGGTTGTC	GTCGACAGGTAATGGTTGTC	1
CCATGTAATTCCACAAGAAT	CCATCTAATTCAACAAGAAT	2
AGAACAGGGCCATCGCAAAT	AGGACAGGGCCATCGCCAAT	2
AGGAACCATCTTCAACGTTC	CGGAACCATCTTCAACGTTG	2
CATCACCTTCACCGTCTCCG	CATCACCTTCACCCTCTCCA	2
CTGTACATAATCTTCGGGCA	CTGTACATAACCTTCGGGCA	1
GGTTGTCTGGTCAAAGGACA	GGTTGTCTGGTAAAAGGACA	1
GTTTGATGTGATACGGATAA	GTTTCATGTGATCCGGATAA	2
ATAGTGCTCTGCTAGTTGAA	ATAATGGTCTGCTAGTTGAA	2
CAGTAGTGGAAATAAATTTG	CAGTAGTGCAAATAAATTTA	2
CCATGTAATTCAACAAGAAT	CCATCTAATTCAACAAGAAT	1
CATCACCTTCTCCCTCTCCA	CATCACCTTCACCCTCTCCA	1
TTGGATTATTTTGTTGAAAA	TTGGAGTATTTTGTTGATAA	2
GGTAATTGCTGTCTGGTAAA	GGTAATGGTTGTCTGGTAAA	2
GATTGTCTGGTAAAAGGACA	GGTTGTCTGGTAAAAGGACA	1
GGCGACAGGTAATGGTTGTC	GTCGACAGGTAATGGTTGTC	1
GCGTTCCTGAACATAACCTT	GCGTTCCTGTACATAACCTT	1
CAAGTGGTCACGCTTTCCGT	CATGTGGTCACGCTTTTCGT	2
CGCTCCTGTACTTAACCTTC	CGTTCCTGTACATAACCTTC	2
CGGATTGTGTCGTCAGGTAA	CAGATTGTGTCGACAGGTAA	2
GGTAATGGTTGTGTGGTAAT	GGTAATGGTTGTCTGGTAAA	2
TTTCGTTGGGATCTTTCGCA	TTTCGTTGGGATCTTTCGAA	1
CAGCAGTTACAGACTCAAGA	CAGCAGTTACAAACTCAAGA	1
CATCACCTTCAGCCTCTCCA	CATCACCTTCACCCTCTCCA	1
GGTAATGGTTTTCTGGTAAA	GGTAATGGTTGTCTGGTAAA	1
TTCGAGTATTCTGTTGATAA	TTGGAGTATTTTGTTGATAA	2
GCGTTCCTGTACATAATCTT	GCGTTCCTGTACATAACCTT	1
CATCTAATCCAACAAGAATT	CATCTAATTCAACAAGAATT	1
AGGACTGGTCCATCGCCAAT	AGGACAGGGCCATCGCCAAT	2
GGTTGGCTGTTAAAAGGACA	GGTTGTCTGGTAAAAGGACA	2
CAGCCGTTACAAACTCAAGC	CAGCAGTTACAAACTCAAGA	2
GGAAAAGCAATGAACGCCAT	GGAAAAGCATTGAACACCAT	2
CGGAACCATCTTCGACGTTG	CGGAACCATCTTCAACGTTG	1
GGTAGTGGTTGTCTGGTAAT	GGTAATGGTTGTCTGGTAAA	2
CTGTACATAACGTTCGGGCA	CTGTACATAACCTTCGGGCA	1
CCATCTAATTCAACATTAAT	CCATCTAATTCAACAAGAAT	2
ATGCGGGCACGCTTTTCGTT	ATGTGGTCACGCTTTTCGTT	2
ATAATGGTCTGCTAGTTGAG	ATAATGGTCTGCTAGTTGAA	1
TTTCATGTGAGCCGGATAAC	TTTCATGTGATCCGGATAAC	1
CATCAGTTCCAAACTCAAGA	CAGCAGTTACAAACTCAAGA	2
CAGATGGTGTCGAGAGGTAA	CAGATTGTGTCGACAGGTAA	2
GTTTCAGGTGATTCGGATAA	GTTTCATGTGATCCGGATAA	2
CCATATAATTCAACAAGCAT	CCATCTAATTCAACAAGAAT	2
TCATGCCGTTTGATATGATC	TCATGCCGTTTCATGTGATC	2
GTAGTGACAAGTGTTGGCTA	GTAGTGACAAGTGTTGGCCA	1
CGGTAGTGCAAATAAATTTA	CAGTAGTGCAAATAAATTTA	1
TCTGGTTGGGATCTTTCGAA	TTTCGTTGGGATCTTTCGAA	2
AGGACAGGGTCATCGCCATT	AGGACAGGGCCATCGCCAAT	2
GTTTCATGTGATCCGGATAA	GTTTCATGTGATCCGGATAA	0
GTTTCATGTGATCCGGATAA	GTTTCATGTGATCCGGATAA	0
GTTTCATGTGATCCGGATAA	GTTTCATGTGATCCGGATAA	0
GTTTCATGTGATCCGGATAA	GTTTCATGTGATCCGGATAA	0
ATAATAGTCCGCTAGTTGAA	ATAATGGTCTGCTAGTTGAA	2
GTATGGACAAGTGTTGGCCA	GTAGTGACAAGTGTTGGCCA	2
AGGACACGGCCAACGCCAAT	AGGACAGGGCCATCGCCAAT	2
GGAATAGAATTGAACACCAT	GGAAAAGCATTGAACACCAT	2
TCATCCCATTTCATGTGATC	TCATGCCGTTTCATGTGATC	2
GTTTCATGTGATCCGGCTAA	GTTTCATGTGATCCGGATAA	1
TAAGGACAGATTGTTTCGAC	AAAGGACAGATTGTGTCGAC	2
TTAACTCGATACGATTCACA	TTAACTCGATACGATTAACA	1
AGTAGTGCAGATAAGTTTAA	AGTAGTGCAAATAAATTTAA	2
CAATCTAATTCAACTAGAAT	CCATCTAATTCAACAAGAAT	2
AAAGCACACATTGTGTCGAC	AAAGGACAGATTGTGTCGAC	2
CAGATTGTATCGACAGGAAA	CAGATTGTGTCGACAGGTAA	2
TTGGAGTATTTTGTTGATAC	TTGGAGTATTTTGTTGATAA	1
GGAAAAGCATGGAACACCAT	GGAAAAGCATTGAACACCAT	1
TGGTTGTCTGGAAAAGGGAC	TGGTTGTCTGGTAAAAGGAC	2
GCGGTCCTGTACATAACCTT	GCGTTCCTGTACATAACCTT	1
GAATGCAGCACGCGTCTTGT	GACTTCAGCACGCGTCTTGT	2
GGTAATGCTGGTCTGGTAAA	GGTAATGGTTGTCTGGTAAA	2
TTAACTCGATACGATTTATA	TTAACTCGATACGATTAACA	2
AGTAGTGCAAAGGAATTTAA	AGTAGTGCAAATAAATTTAA	2
CAGCTTGTGTCGACAGGTAA	CAGATTGTGTCGACAGGTAA	1
AAAGGACAGATTGTGTCGCC	AAAGGACAGATTGTGTCGAC	1
AGGACCGGGCCATGGCCAAT	AGGACAGGGCCATCGCCAAT	2
AGAGGACAAATTGTGTCGAC	AAAGGACAGATTGTGTCGAC	2
TTAACTCGATACGATCAACA	TTAACTCGATACGATTAACA	1
AACTTTAGCACGCGTCTTGT	GACTTCAGCACGCGTCTTGT	2
TTTCGTTGTGTTCTTTCGAA	TTTCGTTGGGATCTTTCGAA	2
CTATACATAGCCTTCGGGCA	CTGTACATAACCTTCGGGCA	2
ATCTGGTCACGCTTTTCGTT	ATGTGGTCACGCTTTTCGTT	1
CGCAACAATCTTCAACGTTG	CGGAACCATCTTCAACGTTG	2
TCAGGCCTTTTCATGTGATC	TCATGCCGTTTCATGTGATC	2
GTTTCATGTGATACGGAAAA	GTTTCATGTGATCCGGATAA	2
TATCATGTGATACGGATAAC	TTTCATGTGATCCGGATAAC	2
ATAATGGCCTGCTAGTTGAA	ATAATGGTCTGCTAGTTGAA	1
CGTTCCTGTACATAACCTCC	CGTTCCTGTACATAACCTTC	1
AAAGGTCAGATTGTGTCCAC	AAAGGACAGATTGTGTCGAC	2
CAGTAGTGCAAAAAAACTTA	CAGTAGTGCAAATAAATTTA	2
TCATGCTGTTTCATGTGATC	TCATGCCGTTTCATGTGATC	1
CGGAACGATCTTCAACGTTG	CGGAACCATCTTCAACGTTG	1
CGTTCCTGTACATTACCTTC	CGTTCCTGTACATAACCTTC	1
CATATAATTGAACAAGAATT	CATCTAATTCAACAAGAATT	2
AGGTCAGGGCCATCACCAAT	AGGACAGGGCCATCGCCAAT	2
AGGACAGGGCCATCGCCAGT	AGGACAGGGCCATCGCCAAT	1
CCATCAAATTCATCAAGAAT	CCATCTAATTCAACAAGAAT	2
TTAACTCGATACGATTAACT	TTAACTCGATACGATTAACA	1
GGTAATGATTGTCTTGTAAA	GGTAATGGTTGTCTGGTAAA	2
CATCTAATTCAGCACGAATT	CATCTAATTCAACAAGAATT	2
GTAGTGACAAGTGCTGGCCA	GTAGTGACAAGTGTTGGCCA	1
TTTCATGTGATCTGGACAAC	TTTCATGTGATCCGGATAAC	2
ATGTACATTACCTTCGGGCA	CTGTACATAACCTTCGGGCA	2
GTCGACAGGTATTGGTTGTC	GTCGACAGGTAATGGTTGTC	1
TTTCGGTGGGATCTTTCGGA	TTTCGTTGGGATCTTTCGAA	2
GGTAATGCTTGTATGGTAAA	GGTAATGGTTGTCTGGTAAA	2
GTAGTGACAAGTGCGGGCCA	GTAGTGACAAGTGTTGGCCA	2
CATCAACTTCGCCCTCTCCA	CATCACCTTCACCCTCTCCA	2
TGGTTGTCTGGTAAAAGGAC	TGGTTGTCTGGTAAAAGGAC	0
TGGTTGTCTGGTAAAAGGAC	TGGTTGTCTGGTAAAAGGAC	0
TGGTTGTCTGGTAAAAGGAC	TGGTTGTCTGGTAAAAGGAC	0
TGGTTGTCTGGTAAAAGGAC	TGGTTGTCTGGTAAAAGGAC	0
GGAAAAGCATTGGACACCAT	GGAAAAGCATTGAACACCAT	1
TTGGAGTATTCTGTTGATAA	TTGGAGTATTTTGTTGATAA	1
GGTAATGGTTGTCCGGTAAA	GGTAATGGTTGTCTGGTAAA	1
GGAAAAGCATTGAGCACCAT	GGAAAAGCATTGAACACCAT	1
CCTTCTAATCCAACAAGAAT	CCATCTAATTCAACAAGAAT	2
TTGGAGTCTTTTGTTGATAA	TTGGAGTATTTTGTTGATAA	1
ATGTGGTCATGCTTTTCGTT	ATGTGGTCACGCTTTTCGTT	1
GTAGTGATAATTGTTGGCCA	GTAGTGACAAGTGTTGGCCA	2
CGGAACCTTCTTCAACCTTG	CGGAACCATCTTCAACGTTG	2
CATGTGGTCACGCGTTTCGT	CATGTGGTCACGCTTTTCGT	1
GACTTCAGCACGAGTCTTGT	GACTTCAGCACGCGTCTTGT	1
TAACTCGATACGATTAACAA	TAACTCGATACGATTAACAA	0
TAACTCGATACGATTAACAA	TAACTCGATACGATTAACAA	0
TAACTCGATACGATTAACAA	TAACTCGATACGATTAACAA	0
TAACTCGATACGATTAACAA	TAACTCGATACGATTAACAA	0
GCGTTCCTGTACGTAACCTT	GCGTTCCTGTACATAACCTT	1
GTATCATGTGATCCGGATAC	GTTTCATGTGATCCGGATAA	2
CAGCTTGTGTCGACAGGTAC	CAGATTGTGTCGACAGGTAA	2
TGGTTGTCTGGTAAACGGAT	TGGTTGTCTGGTAAAAGGAC	2
GACTTCAGCACGCGTATTGT	GACTTCAGCACGCGTCTTGT	1
GTAGTGGCAAGTGTCGGCCA	GTAGTGACAAGTGTTGGCCA	2
CGATCTAATTCAACAAGAAT	CCATCTAATTCAACAAGAAT	1
GACTTAAGCACGCGGCTTGT	GACTTCAGCACGCGTCTTGT	2
ATAGTGGTCTGCTAGTTGAA	ATAATGGTCTGCTAGTTGAA	1
GCATTCCTGTACATAACCTT	GCGTTCCTGTACATAACCTT	1
GGTTGTCTGGTAAAAGGACT	GGTTGTCTGGTAAAAGGACA	1
TTGTACATAACCTTGGGGCA	CTGTACATAACCTTCGGGCA	2
AGGACAGGGCCACCGCCAAT	AGGACAGGGCCATCGCCAAT	1
GGTAATGGTCGTCTGGTAAA	GGTAATGGTTGTCTGGTAAA	1
CGTTCCTGTGCATAACCTTC	CGTTCCTGTACATAACCTTC	1
AGTAGTGCAATTAGATTTAA	AGTAGTGCAAATAAATTTAA	2
CATGTGGTCACGCTTTTCTT	CATGTGGTCACGCTTTTCGT	1
GTTTCATGTGATCCGGACAA	GTTTCATGTGATCCGGATAA	1
ACAAGTGTGGGCCATGGAAC	ACAAGTGTTGGCCACGGAAC	2
GTTTCATGTGATACGGATAA	GTTTCATGTGATCCGGATAA	1
ATAATGGTCTGCTAGTTGGA	ATAATGGTCTGCTAGTTGAA	1
TAACTCGAAACGATTAACAG	TAACTCGATACGATTAACAA	2
ACATGCCGTTTCATGTGATC	TCATGCCGTTTCATGTGATC	1
CCATCTAATTCAACAAGTAA	CCATCTAATTCAACAAGAAT	2
CAAACTCAAGAAGGACCAGG	CAAACTCAAGAAGGACCATG	1
CAGGGGTTACAAACTCAAGA	CAGCAGTTACAAACTCAAGA	2
CCGTCTAATTCAATAAGAAT	CCATCTAATTCAACAAGAAT	2
GGGTGCCTGTACATAACCTT	GCGTTCCTGTACATAACCTT	2
GGTAATGGTTGTTTGCTAAA	GGTAATGGTTGTCTGGTAAA	2
CATCACCTTCACCCTCTCCT	CATCACCTTCACCCTCTCCA	1
TAACTCGATCCGATTAACAA	TAACTCGATACGATTAACAA	1
TCATGCCGTTACATCTGATC	TCATGCCGTTTCATGTGATC	2
AGGACATGGCCATCGCCAAA	AGGACAGGGCCATCGCCAAT	2
GTAGTGACAAGTGATGGCCA	GTAGTGACAAGTGTTGGCCA	1
GTCGACAGGTGATGGTTGTC	GTCGACAGGTAATGGTTGTC	1
AGTAGTGCAAATAAATGTAA	AGTAGTGCAAATAAATTTAA	1
GTTTCATGGGATCCGGATAA	GTTTCATGTGATCCGGATAA	1
ACAAGTGTTGACCACGGAAC	ACAAGTGTTGGCCACGGAAC	1
GTAGTGACGAGTGTTGACCA	GTAGTGACAAGTGTTGGCCA	2
ATGCGGTCACACTTTTCGTT	ATGTGGTCACGCTTTTCGTT	2
CATCACCTTCTCCCTCTCTA	CATCACCTTCACCCTCTCCA	2
CATTAAATTCAACAAGAATT	CATCTAATTCAACAAGAATT	2
CCATCTAATAAAACAAGAAT	CCATCTAATTCAACAAGAAT	2
GTCGACAGGTTATGGTTATC	GTCGACAGGTAATGGTTGTC	2
CGTTCCTGTACATAACCGTC	CGTTCCTGTACATAACCTTC	1
ATAGTGACACGTGTTGGCCA	GTAGTGACAAGTGTTGGCCA	2
CAGCAGTTACAAACTCAGGA	CAGCAGTTACAAACTCAAGA	1
GACTTCAGCACGCATCTTGT	GACTTCAGCACGCGTCTTGT	1
CCTCACCTTCACCCTCTCCA	CATCACCTTCACCCTCTCCA	1
CAGATTATGTCGAAAGGTAA	CAGATTGTGTCGACAGGTAA	2
GTTTCATGTCATCCGGATAA	GTTTCATGTGATCCGGATAA	1
GGTAATGGTTGTCTACTAAA	GGTAATGGTTGTCTGGTAAA	2
GTCAGAGTCGTGACAAGTGT	GTCAGAGTAGTGACAAGTGT	1
GGTTGTCTGGTAAATGGTCA	GGTTGTCTGGTAAAAGGACA	2
TTAACTCGATACGATAAACA	TTAACTCGATACGATTAACA	1
AAAGGAGAGATTGAGTCGAC	AAAGGACAGATTGTGTCGAC	2
CACCAGTTACAAACTCAAGA	CAGCAGTTACAAACTCAAGA	1
CGGAACCATCTTCAACGTCG	CGGAACCATCTTCAACGTTG	1
CGTTCGTGTACATAACCTTC	CGTTCCTGTACATAACCTTC	1
CATCTAATTAAACAAGAATT	CATCTAATTCAACAAGAATT	1
AAAAGTGTTGGCGACGGAAC	ACAAGTGTTGGCCACGGAAC	2
CGGAACCAACTACAACGTTG	CGGAACCATCTTCAACGTTG	2
AGTTGTCTGGTAAAAGGAAA	GGTTGTCTGGTAAAAGGACA	2
GGTTGTCTGCTAAAAGGACA	GGTTGTCTGGTAAAAGGACA	1
ATTTGGTCACGCGTTTCGTT	ATGTGGTCACGCTTTTCGTT	2
GTTTCCTGTGATCCGGATAA	GTTTCATGTGATCCGGATAA	1
GTCGACTGGTAATGGTTGTC	GTCGACAGGTAATGGTTGTC	1
CAAGGTCAAGAAGGACCATG	CAAACTCAAGAAGGACCATG	2
AGTAGTGCATATAAATTTAA	AGTAGTGCAAATAAATTTAA	1
GTCAGAGTAGTCACAAGTGT	GTCAGAGTAGTGACAAGTGT	1
GTTCATGTGATCCGGATAAC	TTTCATGTGATCCGGATAAC	1
ATGAGGTCACACTTTTCGTT	ATGTGGTCACGCTTTTCGTT	2
CGTTCCTGTACATAAGCTTC	CGTTCCTGTACATAACCTTC	1
CCATATAATTCAACAAGAAT	CCATCTAATTCAACAAGAAT	1
AAAGGACAAAGTGTGTCGAC	AAAGGACAGATTGTGTCGAC	2
GGCTGTCTGGTAAACGGACA	GGTTGTCTGGTAAAAGGACA	2
TCGGCGTATTTTGTTGATAA	TTGGAGTATTTTGTTGATAA	2
CAGTAGTGCAAATAAATGTA	CAGTAGTGCAAATAAATTTA	1
CGGATCCATCTTCAACGTTG	CGGAACCATCTTCAACGTTG	1
TTTCGTTGGAATCTTTCGAA	TTTCGTTGGGATCTTTCGAA	1
CAGATTGTGTCGACAGGGAA	CAGATTGTGTCGACAGGTAA	1
CGTTCGTGTACATAATCTTC	CGTTCCTGTACATAACCTTC	2
AGTAGTGCAAATAAATTTGA	AGTAGTGCAAATAAATTTAA	1
GAGTAGTGCAAATAAATTTG	CAGTAGTGCAAATAAATTTA	2
AGTTCTCTGGTAAAAGGACA	GGTTGTCTGGTAAAAGGACA	2
CAGTACATAACTTTCGGGCA	CTGTACATAACCTTCGGGCA	2
GTCGACAGTTAATGGTTGTC	GTCGACAGGTAATGGTTGTC	1
AAAGCACAGGTTGTGTCGAC	AAAGGACAGATTGTGTCGAC	2
AGTAGTGCAAACAAATTTAA	AGTAGTGCAAATAAATTTAA	1
CTGTACCTAACCTTCTGGCA	CTGTACATAACCTTCGGGCA	2
CAACCTCAAGAGGGACCATG	CAAACTCAAGAAGGACCATG	2
TAACTCGATACCATTAACAA	TAACTCGATACGATTAACAA	1
AAAGGAGAGACTGTGTCGAC	AAAGGACAGATTGTGTCGAC	2
CAGATTGTGTCTACAGGTAA	CAGATTGTGTCGACAGGTAA	1
GCGTTCCTGTACCAAACCTT	GCGTTCCTGTACATAACCTT	2
GTCGACAGGTAATGGCTATC	GTCGACAGGTAATGGTTGTC	2
CAGATTGTGTCGCCAGGTAA	CAGATTGTGTCGACAGGTAA	1
TCATGCCGTTTCATGTGCTC	TCATGCCGTTTCATGTGATC	1
CATGCGGTCACCCTTTTCGT	CATGTGGTCACGCTTTTCGT	2
GTCATAGTAGTGACAAGTGT	GTCAGAGTAGTGACAAGTGT	1
CATTAGTCCAAATAAATTTA	CAGTAGTGCAAATAAATTTA	2
GTCAGAGTAGGGACAAGTGT	GTCAGAGTAGTGACAAGTGT	1
GACTTCAGCACGCATCCTGT	GACTTCAGCACGCGTCTTGT	2
GCGTTCCTGAACATAACGTT	GCGTTCCTGTACATAACCTT	2
TAACTCGATACGACTAACAA	TAACTCGATACGATTAACAA	1
GTGGAGTATTTTGTTGATGA	TTGGAGTATTTTGTTGATAA	2
GTCAGCGTAGTGACAAGTGA	GTCAGAGTAGTGACAAGTGT	2
CGTTCCTGTACATACCCTCC	CGTTCCTGTACATAACCTTC	2
GGAAGAGGATTGAACACCAT	GGAAAAGCATTGAACACCAT	2
CGTTGTCTGGCAAAAGGACA	GGTTGTCTGGTAAAAGGACA	2
CGGAACCATCTTCATCGTTG	CGGAACCATCTTCAACGTTG	1
CAGATTGTGCCGACAGGTAA	CAGATTGTGTCGACAGGTAA	1
TGGTTGGCTGGTAAAACGAC	TGGTTGTCTGGTAAAAGGAC	2
GAATTCAGCACGCGTCTTGT	GACTTCAGCACGCGTCTTGT	1
CAAACTCAAGACGGACCATG	CAAACTCAAGAAGGACCATG	1
GACTTCAGCCCGCGTCTTGT	GACTTCAGCACGCGTCTTGT	1
TTAATTCGATACGATTAACA	TTAACTCGATACGATTAACA	1
CATGTGGTGACGCTTTTCGT	CATGTGGTCACGCTTTTCGT	1
GTCAGAGTAGCGACAAGTGT	GTCAGAGTAGTGACAAGTGT	1
TTTCGTTGGGATCTTCCGAA	TTTCGTTGGGATCTTTCGAA	1
ATAATGGTCTGCAAGTTGAA	ATAATGGTCTGCTAGTTGAA	1
AGTAGTGCAGATAAATTTAC	AGTAGTGCAAATAAATTTAA	2
GCGTTCCTGAAGATAACCTT	GCGTTCCTGTACATAACCTT	2
CATGTGGTCACGCTTTTTGT	CATGTGGTCACGCTTTTCGT	1
CGTTCCTGTACATGACCTTC	CGTTCCTGTACATAACCTTC	1
ATGTGGTCACGGTTTGCGTT	ATGTGGTCACGCTTTTCGTT	2
ATAATGGTCTGCTAGATGAA	ATAATGGTCTGCTAGTTGAA	1
CGGAACCAACTTCAACGTTG	CGGAACCATCTTCAACGTTG	1
TAACTCGATACGATTCACAA	TAACTCGATACGATTAACAA	1
GGTTGTCTGGTAAAGGGACA	GGTTGTCTGGTAAAAGGACA	1
GGTAATGGTTGTCTAGTAAA	GGTAATGGTTGTCTGGTAAA	1
GTCTGAGCAGTGACAAGTGT	GTCAGAGTAGTGACAAGTGT	2
CATCTAATTCAACAGGACTT	CATCTAATTCAACAAGAATT	2
CTGTACAGAACCTTCTGGCA	CTGTACATAACCTTCGGGCA	2
ATGTGGTCACGTTTATCGTT	ATGTGGTCACGCTTTTCGTT	2
CATCACCTTCACCCAGTCCA	CATCACCTTCACCCTCTCCA	2
GGAAAAGCAGTGAACACCCT	GGAAAAGCATTGAACACCAT	2
TGTAGTGCAAATAAGTTTAA	AGTAGTGCAAATAAATTTAA	2
TTTCGTTAGGATCTTACGAA	TTTCGTTGGGATCTTTCGAA	2
GTCTGAGTAGTGACAAGTGT	GTCAGAGTAGTGACAAGTGT	1
TTTGAGTTTTTTGTTGATAA	TTGGAGTATTTTGTTGATAA	2
TAGTTGTGCAAATAAATTTA	CAGTAGTGCAAATAAATTTA	2
CAAACTCAAGAAGGCCCATG	CAAACTCAAGAAGGACCATG	1
GTCGACAGGTAATTGTTGTC	GTCGACAGGTAATGGTTGTC	1
GTCGATAGGTAATGGCTGTC	GTCGACAGGTAATGGTTGTC	2
TTAACTCGATACTATTAACA	TTAACTCGATACGATTAACA	1
TGGTTGTCTGGTGAAAGGAC	TGGTTGTCTGGTAAAAGGAC	1
CGGCAACATCTTCAACGTTG	CGGAACCATCTTCAACGTTG	2
GTCAGAGTAGTGACATGTGT	GTCAGAGTAGTGACAAGTGT	1
TGGTTGTCTGGTAACAGGAC	TGGTTGTCTGGTAAAAGGAC	1
TAACTCGTTACGATTAACAA	TAACTCGATACGATTAACAA	1
TGGGTGGCTGGTAAAAGGAC	TGGTTGTCTGGTAAAAGGAC	2
CTGTACATAACCTTCGGTCC	CTGTACATAACCTTCGGGCA	2
CGTTCCTGTACATAACATTC	CGTTCCTGTACATAACCTTC	1
TTTCATGTGATCCGGATACC	TTTCATGTGATCCGGATAAC	1
CGGAACCATCTTCAATGTTG	CGGAACCATCTTCAACGTTG	1
TTCCATGTGCTCCGGATAAC	TTTCATGTGATCCGGATAAC	2
TAACTCGAGACGATAAACAA	TAACTCGATACGATTAACAA	2
AAAGGACAGATTGTCTTGAC	AAAGGACAGATTGTGTCGAC	2
TGACTCGATACGATTAACGA	TAACTCGATACGATTAACAA	2
GTTTCATGTGATCCGGAGAA	GTTTCATGTGATCCGGATAA	1
AGGACAGGGCCATCGTCAAT	AGGACAGGGCCATCGCCAAT	1
TGGTTGTCTGGTAAAAGTAT	TGGTTGTCTGGTAAAAGGAC	2
ATATGGTCACGCTTTTCGTT	ATGTGGTCACGCTTTTCGTT	1
GGAAAAGGATTGAACACCAT	GGAAAAGCATTGAACACCAT	1
GCGTTCCTGTATATAACCTT	GCGTTCCTGTACATAACCTT	1
GGTACTGGTTGTCAGGTAAA	GGTAATGGTTGTCTGGTAAA	2
AGTAGTGCTACTAAATTTAA	AGTAGTGCAAATAAATTTAA	2
CCATCTAATTCAACAAGAAC	CCATCTAATTCAACAAGAAT	1
TAACTCGATGGGATTAACAA	TAACTCGATACGATTAACAA	2
TTTCATGTGATCCGGATAGC	TTTCATGTGATCCGGATAAC	1
TAACTCGATACGATTAACAG	TAACTCGATACGATTAACAA	1
CATCTGGTCACGCTTTTCGG	CATGTGGTCACGCTTTTCGT	2
CTGTACATAACCTTCGGGGA	CTGTACATAACCTTCGGGCA	1
TAGGAGTATTTTGTTGGTAA	TTGGAGTATTTTGTTGATAA	2
ACAAGTGTTGGACACGGAAC	ACAAGTGTTGGCCACGGAAC	1
TTTACTCGATACGATTAACA	TTAACTCGATACGATTAACA	1
AGGACAGGGCCATCGGCAAT	AGGACAGGGCCATCGCCAAT	1
ACAAGTATTGGCAACGGAAC	ACAAGTGTTGGCCACGGAAC	2
GAAGGACAGATTGTGTCGAC	AAAGGACAGATTGTGTCGAC	1
TAACTCGAGACGATTAACAA	TAACTCGATACGATTAACAA	1
CCATCTAATTCAACAAGCAA	CCATCTAATTCAACAAGAAT	2
GTCCACAGGTAATGGTTGTC	GTCGACAGGTAATGGTTGTC	1
CATGTGGTCACGCTTTTGGT	CATGTGGTCACGCTTTTCGT	1
TTGGAGTATTTTGTTGTTAA	TTGGAGTATTTTGTTGATAA	1
GTAGTGACAAGTGATGTCCA	GTAGTGACAAGTGTTGGCCA	2
GTTGCACGTGATCCGGATAA	GTTTCATGTGATCCGGATAA	2
TAGGAGTATTTTGTTGATTA	TTGGAGTATTTTGTTGATAA	2
AAAGGACAGCTTGTGTCGAC	AAAGGACAGATTGTGTCGAC	1
CGAAAACATCTTCAACGTTG	CGGAACCATCTTCAACGTTG	2
CATCTCGATACGATTAACAA	TAACTCGATACGATTAACAA	2
CAGTAGTCCAAATAAATTTA	CAGTAGTGCAAATAAATTTA	1
GTCGACAGGTAAAGGTTGTC	GTCGACAGGTAATGGTTGTC	1
AGTAGTGTAAATACATTTAA	AGTAGTGCAAATAAATTTAA	2
GGTTCTCTGGAAAAAGGACA	GGTTGTCTGGTAAAAGGACA	2
TCATGCCGTTTCATGTGTTC	TCATGCCGTTTCATGTGATC	1
GTCGACAGGCAATGGTTGTC	GTCGACAGGTAATGGTTGTC	1
GACTTCAGAACTCGTCTTGT	GACTTCAGCACGCGTCTTGT	2
TTAACTGGCTACGATTAACA	TTAACTCGATACGATTAACA	2
TCATGCCGTTCCATGTGATT	TCATGCCGTTTCATGTGATC	2
CAGTAGTGTAAATAAATTTA	CAGTAGTGCAAATAAATTTA	1
GCGTGCTTGTACATAACCTT	GCGTTCCTGTACATAACCTT	2
CCATCTAATTCACCAAGAAT	CCATCTAATTCAACAAGAAT	1
ACAAGGGTTGGCCACGGAAC	ACAAGTGTTGGCCACGGAAC	1
GGTGGTCTGATAAAAGGACA	GGTTGTCTGGTAAAAGGACA	2
CATGTGGTCACGCATTTCGT	CATGTGGTCACGCTTTTCGT	1
CATCTAATTCAACAATAATT	CATCTAATTCAACAAGAATT	1
GTAGTGACGAGTGTTGGCCA	GTAGTGACAAGTGTTGGCCA	1
GTCGACAGGTTATGGTGGTC	GTCGACAGGTAATGGTTGTC	2
CCATCTAATTCTACAAGAAT	CCATCTAATTCAACAAGAAT	1
GTCGACAGGTTATGGTTGTC	GTCGACAGGTAATGGTTGTC	1
GTCCACAGGTAATCGTTGTC	GTCGACAGGTAATGGTTGTC	2
GGTAATGGTTCTCTGGTAAG	GGTAATGGTTGTCTGGTAAA	2
TTTCATGTGATCGGGTTAAC	TTTCATGTGATCCGGATAAC	2
GTAGTGACAAGTGTTGTCCA	GTAGTGACAAGTGTTGGCCA	1
GACTTCAGCAAGCTTCTTGT	GACTTCAGCACGCGTCTTGT	2
TGTCATGTAATCCGGATAAC	TTTCATGTGATCCGGATAAC	2
GTTTCATGTGCTCCGGATAA	GTTTCATGTGATCCGGATAA	1
ACAAGTGCTGGCCACGGAAC	ACAAGTGTTGGCCACGGAAC	1
GGTAATGGTTGTCTGGCAAA	GGTAATGGTTGTCTGGTAAA	1
CATCACCTTCACCCTATCCA	CATCACCTTCACCCTCTCCA	1
GAGATTCTGTCGACAGGTAA	CAGATTGTGTCGACAGGTAA	2
TCATGCGGTTTCATGTGATC	TCATGCCGTTTCATGTGATC	1
TTGGAGTATTTTGTGGATAA	TTGGAGTATTTTGTTGATAA	1
TAACACGTTACGATTAACAA	TAACTCGATACGATTAACAA	2
CGGAACCGTCTTCAAAGTTG	CGGAACCATCTTCAACGTTG	2
TTTCATGTGATTCGGATAAC	TTTCATGTGATCCGGATAAC	1
AGGACAGGGCCAGCGCCAAT	AGGACAGGGCCATCGCCAAT	1
CAGTAGTCCAAATAAAGTTA	CAGTAGTGCAAATAAATTTA	2
AAAGGACAGATTGTGTCCAC	AAAGGACAGATTGTGTCGAC	1
GGTAATGGTTGTCTGTTAAA	GGTAATGGTTGTCTGGTAAA	1
CTTGTGGTCACGCTTTTCGT	CATGTGGTCACGCTTTTCGT	1
GTCAGAATAGTGACAAGTGT	GTCAGAGTAGTGACAAGTGT	1
ATGTGGTCACGCATTTCGTT	ATGTGGTCACGCTTTTCGTT	1
GTTTCTTGTGATCCGGACAA	GTTTCATGTGATCCGGATAA	2
GGACAAGCATTGAACACCAT	GGAAAAGCATTGAACACCAT	1
TTGGAGTATTTTGCTGATAA	TTGGAGTATTTTGTTGATAA	1
GGTTGTCTGGTCCAAGGACA	GGTTGTCTGGTAAAAGGACA	2
CATCTAATTCAACAAGATTT	CATCTAATTCAACAAGAATT	1
GTTTCATATGATCCGGATAA	GTTTCATGTGATCCGGATAA	1
ACGTCGTCACGCTTTTCGTT	ATGTGGTCACGCTTTTCGTT	2
AGTAGTGCAAATAACTTTAA	AGTAGTGCAAATAAATTTAA	1
ATGTGGTCACGCGTTTCGTT	ATGTGGTCACGCTTTTCGTT	1
TTTCGTTGGGATCTTGCGAA	TTTCGTTGGGATCTTTCGAA	1
CATTTATTTCAACAAGAATT	CATCTAATTCAACAAGAATT	2
CGTAACCATCTTCAACGTTG	CGGAACCATCTTCAACGTTG	1
CAGTTTGTGTCTACAGGTAA	CAGATTGTGTCGACAGGTAA	2
GTTCCATGTGATCCCGATAA	GTTTCATGTGATCCGGATAA	2
GACTTCAGCACGAATCTTGT	GACTTCAGCACGCGTCTTGT	2
CAGATTGTATCGTCAGGTAA	CAGATTGTGTCGACAGGTAA	2
GGCAATGGTTGTCTGGTAAA	GGTAATGGTTGTCTGGTAAA	1
CGTTCCTGCATATAACCTTC	CGTTCCTGTACATAACCTTC	2
CAGTTGTGCAAAAAAATTTA	CAGTAGTGCAAATAAATTTA	2
GGTTGTCTGGTACAGGGACA	GGTTGTCTGGTAAAAGGACA	2
GGCAAAGCATTGAAAACCAT	GGAAAAGCATTGAACACCAT	2
GGTAATGGTTGTCCGGTAAG	GGTAATGGTTGTCTGGTAAA	2
CATCAAATTCAACAAGAATT	CATCTAATTCAACAAGAATT	1
GAGCAGTTACAAACTCCAGA	CAGCAGTTACAAACTCAAGA	2
CCACCTCATTCAACAAGAAT	CCATCTAATTCAACAAGAAT	2
GACTTTAGCACGCGTCTTGT	GACTTCAGCACGCGTCTTGT	1
GCAAGTGTTGGCCACGGAGC	ACAAGTGTTGGCCACGGAAC	2
CGTTCCTGGACATAACCTTC	CGTTCCTGTACATAACCTTC	1
GCGTTCCTCTACATAACTTT	GCGTTCCTGTACATAACCTT	2
AGAAGTGTTGGCCACGGAAC	ACAAGTGTTGGCCACGGAAC	1
TTGGAGTATTTTGTTCATAA	TTGGAGTATTTTGTTGATAA	1
ACAAGTGTTTGCCACAGAAC	ACAAGTGTTGGCCACGGAAC	2
CCATCTAATTCAAGAAGAAT	CCATCTAATTCAACAAGAAT	1
CAGCAGTGCAAATAAAGTTA	CAGTAGTGCAAATAAATTTA	2
AGGTTGTCTGGTAAAATGAC	TGGTTGTCTGGTAAAAGGAC	2
GACTTCAGCACGCTTCTTGT	GACTTCAGCACGCGTCTTGT	1
GGTTGTCTGGTAAAATGACT	GGTTGTCTGGTAAAAGGACA	2
CATCAGCTTCACTCTCTCCA	CATCACCTTCACCCTCTCCA	2
TTTCGTTCGTATCTTTCGAA	TTTCGTTGGGATCTTTCGAA	2
CATCTAATTCTACAAGAATT	CATCTAATTCAACAAGAATT	1
CTGTACATAACCTTCGCGCA	CTGTACATAACCTTCGGGCA	1
AAAGGACAGAATGTATCGAC	AAAGGACAGATTGTGTCGAC	2
GGTGATGGTTGTCTGGTAAA	GGTAATGGTTGTCTGGTAAA	1
GTTTCATGTGATCCTGATGA	GTTTCATGTGATCCGGATAA	2
CGGAACCATCTTCAACGCTG	CGGAACCATCTTCAACGTTG	1
CGGAACCATCTTCAAGGTTG	CGGAACCATCTTCAACGTTG	1
CCATCTAATTCAACGAGCAT	CCATCTAATTCAACAAGAAT	2
ACAAGTGTTGGCCAAGGAAC	ACAAGTGTTGGCCACGGAAC	1
GGGTTCCTGTACAAAACCTT	GCGTTCCTGTACATAACCTT	2
CCTCAAATTCAACAAGAATT	CATCTAATTCAACAAGAATT	2
ACAAGTGTTGGCCACGCAAC	ACAAGTGTTGGCCACGGAAC	1
CAGTAGTGCAATTAAATTTA	CAGTAGTGCAAATAAATTTA	1
CAAACTCAAGAATGACCATG	CAAACTCAAGAAGGACCATG	1
AAAAGTGTTGGCCACGGAAC	ACAAGTGTTGGCCACGGAAC	1
GTCGACAGGTAATGGCTGTC	GTCGACAGGTAATGGTTGTC	1
AAAGGACAGAATGTGTCGAC	AAAGGACAGATTGTGTCGAC	1
TGTCGTTCGGATCTTTCGAA	TTTCGTTGGGATCTTTCGAA	2
GCGTTCCTGTACATACCCTT	GCGTTCCTGTACATAACCTT	1
CGTACCTGTACATAACCTTC	CGTTCCTGTACATAACCTTC	1
CATGTAATTCAACAAGAATT	CATCTAATTCAACAAGAATT	1
ACGAGTTTTGGCCACGGAAC	ACAAGTGTTGGCCACGGAAC	2
CTGTACATAACCTTCGAGCA	CTGTACATAACCTTCGGGCA	1
CATCACCCTCACCCTCTCCA	CATCACCTTCACCCTCTCCA	1
ATGTGGTCACGGTTTTCGTT	ATGTGGTCACGCTTTTCGTT	1
ACAAGTGTCTGCCACGGAAC	ACAAGTGTTGGCCACGGAAC	2
GTAGTGAAAAGTGTTGGCCA	GTAGTGACAAGTGTTGGCCA	1
CAGCAGTGTCAAACTCAAGA	CAGCAGTTACAAACTCAAGA	2
TGAACTCGATACGATTAACA	TTAACTCGATACGATTAACA	1
GTCGACAGATAATGGTTGTC	GTCGACAGGTAATGGTTGTC	1
TGTAGTGCAAATAAATTTAA	AGTAGTGCAAATAAATTTAA	1
GTTTCATTTGATCCGGATAA	GTTTCATGTGATCCGGATAA	1
TAATTCTATACGATTAACAA	TAACTCGATACGATTAACAA	2
AGGAGTGCAAATAAATTTAG	AGTAGTGCAAATAAATTTAA	2
TCAGGCCGTTTCATGTGATT	TCATGCCGTTTCATGTGATC	2
TTTCACGTGATCCGGATACC	TTTCATGTGATCCGGATAAC	2
CTGCAGTTACAAACTCAAGA	CAGCAGTTACAAACTCAAGA	1
TAACTCGATCCGATTAAAAA	TAACTCGATACGATTAACAA	2
GACTGCAGCACGCGTCTTGT	GACTTCAGCACGCGTCTTGT	1
CATATCGTCACGCTTTTCGT	CATGTGGTCACGCTTTTCGT	2
AGTAGTGCAATTAAATTTAA	AGTAGTGCAAATAAATTTAA	1
CTGTACATAACCATCGGGCA	CTGTACATAACCTTCGGGCA	1
AGGACGGGGCCATCGCCAAT	AGGACAGGGCCATCGCCAAT	1
TCATGCCGTTTCATGTGATT	TCATGCCGTTTCATGTGATC	1
CTGGAGTATTTGGTTGATAA	TTGGAGTATTTTGTTGATAA	2
TTGGAGTATCTTGTTCATAA	TTGGAGTATTTTGTTGATAA	2
CAAACTCAAGAAGGACCGTG	CAAACTCAAGAAGGACCATG	1
ATAGGACAGATTGTGCCGAC	AAAGGACAGATTGTGTCGAC	2
CAGATAGTGTCGACAGGTAA	CAGATTGTGTCGACAGGTAA	1
GGTTGACTGGTATAAGGACA	GGTTGTCTGGTAAAAGGACA	2
GCGTTCCTGTACATAACCCT	GCGTTCCTGTACATAACCTT	1
AGGACAGTGCCTTCGCCAAT	AGGACAGGGCCATCGCCAAT	2
GCATTCCTGCACATAACCTT	GCGTTCCTGTACATAACCTT	2
GTAGTGACAAGTGATTGCCA	GTAGTGACAAGTGTTGGCCA	2
CAAACTCATGAAGGACCATG	CAAACTCAAGAAGGACCATG	1
CATCTTATTCATCAAGAATT	CATCTAATTCAACAAGAATT	2
CAGATTGTGTTGACAGGTAA	CAGATTGTGTCGACAGGTAA	1
GCGTTCCTGTACATATCCTT	GCGTTCCTGTACATAACCTT	1
TTGGTGTATTTTGTTGATAA	TTGGAGTATTTTGTTGATAA	1
CAGATTATGTCGACAGGTAA	CAGATTGTGTCGACAGGTAA	1
GGTAATGGTTGGCTGGTAAA	GGTAATGGTTGTCTGGTAAA	1
GGTAATGGTTGTCTGGTAAG	GGTAATGGTTGTCTGGTAAA	1
CGTGTGGTCAGGCTTTTCGT	CATGTGGTCACGCTTTTCGT	2
TCATGCCGTTTCATGTGATG	TCATGCCGTTTCATGTGATC	1
CTGTACATAACCTTCGGGCA	CTGTACATAACCTTCGGGCA	0
CTGTACATAACCTTCGGGCA	CTGTACATAACCTTCGGGCA	0
CTGTACATAACCTTCGGGCA	CTGTACATAACCTTCGGGCA	0
CTGTACATAACCTTCGGGCA	CTGTACATAACCTTCGGGCA	0
CATCACCTACACCCTCTCCA	CATCACCTTCACCCTCTCCA	1
ATATTGATCTGCTAGTTGAA	ATAATGGTCTGCTAGTTGAA	2
GGTAATGGTTGTCTGGTATA	GGTAATGGTTGTCTGGTAAA	1
ACAAGTGCTGGCCACGGAGC	ACAAGTGTTGGCCACGGAAC	2
CAGCAGTTACAAACTCAACA	CAGCAGTTACAAACTCAAGA	1
GCGTTCCTGAACTTAACCTT	GCGTTCCTGTACATAACCTT	2
TGGTTGTCTGGTATAAGGAC	TGGTTGTCTGGTAAAAGGAC	1
CTGCAGTTAAAAACTCAAGA	CAGCAGTTACAAACTCAAGA	2
TTTCGTTGGGTTCTTTCGAA	TTTCGTTGGGATCTTTCGAA	1
CAAACTCCAGAAGGACCAGG	CAAACTCAAGAAGGACCATG	2
AGTAAAGGTTGTCTGGTAAA	GGTAATGGTTGTCTGGTAAA	2
GACTTCAGCACGTGTCTCGT	GACTTCAGCACGCGTCTTGT	2
TGGTTGTCTGGTAACACGAC	TGGTTGTCTGGTAAAAGGAC	2
CGGAACCATCTGCAACGTTG	CGGAACCATCTTCAACGTTG	1
ATGTGGTCACGCTCTTCGTT	ATGTGGTCACGCTTTTCGTT	1
GTCGACAGGTAATGGTTGTG	GTCGACAGGTAATGGTTGTC	1
GGTTGTCTGGTCAAAGGAGA	GGTTGTCTGGTAAAAGGACA	2
TGGTTGTCTGTTAAAAGGAC	TGGTTGTCTGGTAAAAGGAC	1
GGAAAAGCATTTAACACCAT	GGAAAAGCATTGAACACCAT	1
TTAACTCGATACCATTAACA	TTAACTCGATACGATTAACA	1
AACGGACAAATTGTGTCGAC	AAAGGACAGATTGTGTCGAC	2
TCATGCCGTTTGATGTGATC	TCATGCCGTTTCATGTGATC	1
ATAATGGTCTGCTGGTTGAA	ATAATGGTCTGCTAGTTGAA	1
ACAGGACAGATTGTGTCGAC	AAAGGACAGATTGTGTCGAC	1
TTTACTCGATACGAGTAACA	TTAACTCGATACGATTAACA	2
GCGTTCCTGTAAATAACCTT	GCGTTCCTGTACATAACCTT	1
GTCAGAGTAGTGACTAGTGT	GTCAGAGTAGTGACAAGTGT	1
GACAGAGTACTGACAAGTGT	GTCAGAGTAGTGACAAGTGT	2
GGAAAAGTATTGAACACCAT	GGAAAAGCATTGAACACCAT	1
GAAGTGATAAGTGTTGGCCA	GTAGTGACAAGTGTTGGCCA	2
GTTTCATGTGAACCGGATAA	GTTTCATGTGATCCGGATAA	1
GTAGTGACAAGTGTGGACCA	GTAGTGACAAGTGTTGGCCA	2
AAAGGACAGATTGTGACGAT	AAAGGACAGATTGTGTCGAC	2
GTAGTGACAAGGGTTGGCCA	GTAGTGACAAGTGTTGGCCA	1
TTAACTCGATACGATTAACA	TTAACTCGATACGATTAACA	0
TTAACTCGATACGATTAACA	TTAACTCGATACGATTAACA	0
TTAACTCGATACGATTAACA	TTAACTCGATACGATTAACA	0
TTAACTCGATACGATTAACA	TTAACTCGATACGATTAACA	0
CATCTAATTCAACAAGAAAT	CATCTAATTCAACAAGAATT	1
CATGTGGTCAAGATTTTCGT	CATGTGGTCACGCTTTTCGT	2
CATCACCTTCACCTTCGCCA	CATCACCTTCACCCTCTCCA	2
AAAGGACAGAATGTGTCGTC	AAAGGACAGATTGTGTCGAC	2
CGGAACCATCTTCAACATTG	CGGAACCATCTTCAACGTTG	1
CCATCTAATTCAACAGGAAT	CCATCTAATTCAACAAGAAT	1
GGTAATGGTTCTCTGGTAAC	GGTAATGGTTGTCTGGTAAA	2
CATCTAATTCAACAAGAATA	CATCTAATTCAACAAGAATT	1
TGGTTGTCTGGTAAAGGGAC	TGGTTGTCTGGTAAAAGGAC	1
TGGTTGTTTGGTAAAAGGAG	TGGTTGTCTGGTAAAAGGAC	2
GTCGAGCGGTAATGGTTGTC	GTCGACAGGTAATGGTTGTC	2
GGTAATGGTTGTCGGGTATA	GGTAATGGTTGTCTGGTAAA	2
ACCAGTGTTGACCACGGAAC	ACAAGTGTTGGCCACGGAAC	2
GGATGTCTGGTAAAAGGTCA	GGTTGTCTGGTAAAAGGACA	2
CGTACCTGTACATAACATTC	CGTTCCTGTACATAACCTTC	2
GTCAGAGTAGTGACAACTAT	GTCAGAGTAGTGACAAGTGT	2
CGTTCCTGAATATAACCTTC	CGTTCCTGTACATAACCTTC	2
GGAAAAGCATTGAACACCCT	GGAAAAGCATTGAACACCAT	1
ACAAGTGTTGGCCACGGTAC	ACAAGTGTTGGCCACGGAAC	1
CGGAACCATCTTAAATGTTG	CGGAACCATCTTCAACGTTG	2
CAAACTCATGTAGGACCATG	CAAACTCAAGAAGGACCATG	2
GACTTGAGCACGCGTCTTGT	GACTTCAGCACGCGTCTTGT	1
TCATTCCGTTTCGTGTGATC	TCATGCCGTTTCATGTGATC	2
AGGTGGTCACGCTTTGCGTT	ATGTGGTCACGCTTTTCGTT	2
GGGACAGGGCCATCGCCAAT	AGGACAGGGCCATCGCCAAT	1
GTCAGAGTAGTGACCAGTGA	GTCAGAGTAGTGACAAGTGT	2
GTCAGAGTAGTGACAGGTGT	GTCAGAGTAGTGACAAGTGT	1
TTAGCACGATACGATTAACA	TTAACTCGATACGATTAACA	2
GTCGACAGGTAATGGTTGCC	GTCGACAGGTAATGGTTGTC	1
GGAAAAGCATTGTACACCAT	GGAAAAGCATTGAACACCAT	1
GGTAAAGCATTGAACACCTT	GGAAAAGCATTGAACACCAT	2
TTGGGGTATTTTGTTGATAA	TTGGAGTATTTTGTTGATAA	1
ACAAGTGTTAGCCACGTAAC	ACAAGTGTTGGCCACGGAAC	2
AAAGGACAGATAGTGTCGAC	AAAGGACAGATTGTGTCGAC	1
CCTTCTAATTCAACAAGAAT	CCATCTAATTCAACAAGAAT	1
GTCGACAGGTAATGCTTGTC	GTCGACAGGTAATGGTTGTC	1
ATGTGGTCACGCTTCTCGTC	ATGTGGTCACGCTTTTCGTT	2
TTTCGTTGGGATCTGTCGAA	TTTCGTTGGGATCTTTCGAA	1
TTAACTCGATACGAGTAAAA	TTAACTCGATACGATTAACA	2
TCATGCCGGTTCATGTGATC	TCATGCCGTTTCATGTGATC	1
CGAAACCATATTCAACGTTG	CGGAACCATCTTCAACGTTG	2
GTTTCATGTGGTCCGGATAA	GTTTCATGTGATCCGGATAA	1
CAAACTCACGAAGGACGATG	CAAACTCAAGAAGGACCATG	2
CTGTACATAACCGTCGGGCA	CTGTACATAACCTTCGGGCA	1
GGTACATGTGATCCGGATAA	GTTTCATGTGATCCGGATAA	2
ATGTGGTCTCGCTTTTCGTT	ATGTGGTCACGCTTTTCGTT	1
GTCAGAGTAGTGGCAAGTGT	GTCAGAGTAGTGACAAGTGT	1
CATTCGTGCAAATAAATTTA	CAGTAGTGCAAATAAATTTA	2
CCATCTAATACAACAAGAAT	CCATCTAATTCAACAAGAAT	1
CGTTCCTGTCCATAACCTTC	CGTTCCTGTACATAACCTTC	1
CATGTGGTCACGCTATTCGT	CATGTGGTCACGCTTTTCGT	1
GTCAGAGGAGTCACAAGTGT	GTCAGAGTAGTGACAAGTGT	2
GGAAAAGCATAGAACACCAT	GGAAAAGCATTGAACACCAT	1
CGCTCCTGTACATAACCTTC	CGTTCCTGTACATAACCTTC	1
ATGTGGTCACGCTTTCCGTT	ATGTGGTCACGCTTTTCGTT	1
TTGGACTATATTGTTGATAA	TTGGAGTATTTTGTTGATAA	2
CCGTACATAACCTTCGGGCA	CTGTACATAACCTTCGGGCA	1
TGAAAAGCATTGAACACCAT	GGAAAAGCATTGAACACCAT	1
CATGTGGTCACGATCTTCGT	CATGTGGTCACGCTTTTCGT	2
GGTAATGGTTGTCTGTTAAC	GGTAATGGTTGTCTGGTAAA	2
GGTTTTCTGGTAATAGGACA	GGTTGTCTGGTAAAAGGACA	2
TCGTTCCTGTACATAACCTT	GCGTTCCTGTACATAACCTT	1
GTCGACAGGTTTTGGTTGTC	GTCGACAGGTAATGGTTGTC	2
GTAGTGACAAGCGTTGGCCA	GTAGTGACAAGTGTTGGCCA	1
CATCTAACTCAACAACAATT	CATCTAATTCAACAAGAATT	2
AGGACAGGGCCATCGCGAAT	AGGACAGGGCCATCGCCAAT	1
GCGTTCCTGTACATAACTTT	GCGTTCCTGTACATAACCTT	1
AGTAGTGCAAATAAATTTGC	AGTAGTGCAAATAAATTTAA	2
CGTTCCTGTACAAAACCTTC	CGTTCCTGTACATAACCTTC	1
CTGAACCATCTTCAACATTG	CGGAACCATCTTCAACGTTG	2
CCATCTAATTCAACACGAGT	CCATCTAATTCAACAAGAAT	2
ATGTGGTCCCGCTTTGCGTT	ATGTGGTCACGCTTTTCGTT	2
CTGTGGTCACGCTTTTCGTT	ATGTGGTCACGCTTTTCGTT	1
GTAGTGACATGTGTTGCCCA	GTAGTGACAAGTGTTGGCCA	2
TTGGAGTATTTTGTTGATCA	TTGGAGTATTTTGTTGATAA	1
GTAGTGCCAAGTGTTGGGCA	GTAGTGACAAGTGTTGGCCA	2
GCGTACCTGTACATAACCCT	GCGTTCCTGTACATAACCTT	2
TAACTCGATACGTTTAAGAA	TAACTCGATACGATTAACAA	2
TGGTTGTATGGTAAAAGGAC	TGGTTGTCTGGTAAAAGGAC	1
TTGGAGGATTTTGGTGATAA	TTGGAGTATTTTGTTGATAA	2
CATCACCTTTACCCTTTCCA	CATCACCTTCACCCTCTCCA	2
AAAGGACAGATTGTGTCGTC	AAAGGACAGATTGTGTCGAC	1
GAGTAGTGCAAATCAATTTA	CAGTAGTGCAAATAAATTTA	2
TGACTCGATACGATTAACAA	TAACTCGATACGATTAACAA	1
CATCTAATTCAACAAGAATT	CATCTAATTCAACAAGAATT	0
CATCTAATTCAACAAGAATT	CATCTAATTCAACAAGAATT	0
CATCTAATTCAACAAGAATT	CATCTAATTCAACAAGAATT	0
CATCTAATTCAACAAGAATT	CATCTAATTCAACAAGAATT	0
TTGTTGTGTGGTAAAAGGAC	TGGTTGTCTGGTAAAAGGAC	2
TCATGCCGTTTCATTTGATC	TCATGCCGTTTCATGTGATC	1
GGTTGTCGCGTAAAAGGACA	GGTTGTCTGGTAAAAGGACA	2
CATCTAACTCAACAAGAATT	CATCTAATTCAACAAGAATT	1
GGTTGTCTGGTAAAAGAACA	GGTTGTCTGGTAAAAGGACA	1
GTCGACAGCTAACGGTTGTC	GTCGACAGGTAATGGTTGTC	2
CAGCAGTTAAAAACTCAAGA	CAGCAGTTACAAACTCAAGA	1
GGTTGTGGTTGTCTGGTAAA	GGTAATGGTTGTCTGGTAAA	2
GGTTCTCTGGTAAAAGGACA	GGTTGTCTGGTAAAAGGACA	1
AGTAGTGCAAATATATTTAA	AGTAGTGCAAATAAATTTAA	1
CATTTGGTCACGCTTTTCGT	CATGTGGTCACGCTTTTCGT	1
CAGTAGTGCAAATAAATTGA	CAGTAGTGCAAATAAATTTA	1
GGTTGTCTGGTAAATGGACA	GGTTGTCTGGTAAAAGGACA	1
AGTAGTGCAAATAAATTTAA	AGTAGTGCAAATAAATTTAA	0
AGTAGTGCAAATAAATTTAA	AGTAGTGCAAATAAATTTAA	0
AGTAGTGCAAATAAATTTAA	AGTAGTGCAAATAAATTTAA	0
AGTAGTGCAAATAAATTTAA	AGTAGTGCAAATAAATTTAA	0
GTTTCATGTTATCCGGATAA	GTTTCATGTGATCCGGATAA	1
GGTAAGGGTTGTCTGGTAAA	GGTAATGGTTGTCTGGTAAA	1
CTGTACATAACCGACGGGCA	CTGTACATAACCTTCGGGCA	2
GGAAAATCATTGAACACCAT	GGAAAAGCATTGAACACCAT	1
CTGTACATAACCTTCTGGCA	CTGTACATAACCTTCGGGCA	1
GCGTTCCTCTACATAACCTT	GCGTTCCTGTACATAACCTT	1
TTTCGTTGGGATCTTTCGGA	TTTCGTTGGGATCTTTCGAA	1
AGGACAGGGCCAGCACCAAT	AGGACAGGGCCATCGCCAAT	2
CTTCCTTGGGATCTTTCGAA	TTTCGTTGGGATCTTTCGAA	2
CATGTGGTCACACTTTTCGT	CATGTGGTCACGCTTTTCGT	1
CGTTCCTGTACAGAACCTTC	CGTTCCTGTACATAACCTTC	1
GCATCTAATTCAAAAAGAAT	CCATCTAATTCAACAAGAAT	2
TTGCATCTGATCCGGATAAC	TTTCATGTGATCCGGATAAC	2
TGGTTGTCGGGTAAAAGGAC	TGGTTGTCTGGTAAAAGGAC	1
ACAAGTGTTGGCCACTGAAC	ACAAGTGTTGGCCACGGAAC	1
CTGTACGTAACCTTCGGGCA	CTGTACATAACCTTCGGGCA	1
GGAAAAGGCTTGAACACCAT	GGAAAAGCATTGAACACCAT	2
ATGTGGTCACGCTTTTCGTG	ATGTGGTCACGCTTTTCGTT	1
CATCATCTTCACCCTCTCAA	CATCACCTTCACCCTCTCCA	2
GTCAGAGTAGTGACAATTGT	GTCAGAGTAGTGACAAGTGT	1
GGTTGTCTGATAAAAGGACA	GGTTGTCTGGTAAAAGGACA	1
ATGTCGTCACGCTTTACGTT	ATGTGGTCACGCTTTTCGTT	2
TTTCGTTGGGATTTTTCGAA	TTTCGTTGGGATCTTTCGAA	1
TCCTGCCGTTTCATGTGATC	TCATGCCGTTTCATGTGATC	1
CGGAAACATCTTCAACGTCG	CGGAACCATCTTCAACGTTG	2
CAATAGTGCAGATAAATTTA	CAGTAGTGCAAATAAATTTA	2
TTCCATGTGATCCGGATAAC	TTTCATGTGATCCGGATAAC	1
AGGACAGCGCCCTCGCCAAT	AGGACAGGGCCATCGCCAAT	2
TGAAAAGCATTGAACCCCAT	GGAAAAGCATTGAACACCAT	2
CAGATTGTGTCAACAGGTAA	CAGATTGTGTCGACAGGTAA	1
GTTTCATGTGATCCTGATAA	GTTTCATGTGATCCGGATAA	1
CTGTACATAACCTTCGGGCT	CTGTACATAACCTTCGGGCA	1
GTCAGAGTAGTTACAAGTGT	GTCAGAGTAGTGACAAGTGT	1
ATGTGGTCACGCTTCTCGTT	ATGTGGTCACGCTTTTCGTT	1
AGTAGTGCAAATAAATTTCA	AGTAGTGCAAATAAATTTAA	1
GCGTTCCTGTACACAATCTT	GCGTTCCTGTACATAACCTT	2
CGGAACCATCTTTAACGTTT	CGGAACCATCTTCAACGTTG	2
TTTCGTGTGATCCGAATAAC	TTTCATGTGATCCGGATAAC	2
GACTTCAGCACGCGTCTTCT	GACTTCAGCACGCGTCTTGT	1
TCATGCCGTTTCAGGTGATC	TCATGCCGTTTCATGTGATC	1
AGTTGTCTGGTATAAGGACA	GGTTGTCTGGTAAAAGGACA	2
CTGTACATAACATTCGGGCA	CTGTACATAACCTTCGGGCA	1
CATCTAATTCAACAAAAATT	CATCTAATTCAACAAGAATT	1
ATGTGGTCACCCTTTTCGTT	ATGTGGTCACGCTTTTCGTT	1
CGTGGCTGTACATAACCTTC	CGTTCCTGTACATAACCTTC	2
AGGAACCTTCTTCAACGTTG	CGGAACCATCTTCAACGTTG	2
AGTAGCGCCAATAAATTTAA	AGTAGTGCAAATAAATTTAA	2
CAGTAGTTACAAACTCAAGA	CAGCAGTTACAAACTCAAGA	1
ATAATGATCTGCTAGTTGAG	ATAATGGTCTGCTAGTTGAA	2
TGGTTGACTGGTATAAGGAC	TGGTTGTCTGGTAAAAGGAC	2
CATCACCTTCACTATCTCCA	CATCACCTTCACCCTCTCCA	2
TTAACTTGATATGATTAACA	TTAACTCGATACGATTAACA	2
ATAATGGTCGGCTAGTTGAA	ATAATGGTCTGCTAGTTGAA	1
AAAGGACAGCTGGTGTCGAC	AAAGGACAGATTGTGTCGAC	2
TAGCTCTATACGATTAACAA	TAACTCGATACGATTAACAA	2
TGGGAGTATTTTGTTGATAA	TTGGAGTATTTTGTTGATAA	1
CAAACTCAAGATGGACCAAG	CAAACTCAAGAAGGACCATG	2
AAAAGACAGATTTTGTCGAC	AAAGGACAGATTGTGTCGAC	2
TTTCGTTGCGATCTTTCGAA	TTTCGTTGGGATCTTTCGAA	1
AAAGGAGAGATTGTGCCGAC	AAAGGACAGATTGTGTCGAC	2
TTAACTCGATACGATTAACG	TTAACTCGATACGATTAACA	1
GGTAATGGTAGGCTGGTAAA	GGTAATGGTTGTCTGGTAAA	2
CCGCAGTTACAATCTCAAGA	CAGCAGTTACAAACTCAAGA	2
AAAGGACACATTGTGTCGAC	AAAGGACAGATTGTGTCGAC	1
TACTTCAGCACGGGTCTTGT	GACTTCAGCACGCGTCTTGT	2
ACTAGTGCAAATAAATTTAA	AGTAGTGCAAATAAATTTAA	1
ATCGACAAGTAATGGTTGTC	GTCGACAGGTAATGGTTGTC	2
TCATGCCCTCTCATGTGATC	TCATGCCGTTTCATGTGATC	2
GGAAAAGCATTGTATACCAT	GGAAAAGCATTGAACACCAT	2
CAAACTAAAGACGGACCATG	CAAACTCAAGAAGGACCATG	2
CAGTAGTGCAAATAAATTTA	CAGTAGTGCAAATAAATTTA	0
CAGTAGTGCAAATAAATTTA	CAGTAGTGCAAATAAATTTA	0
CAGTAGTGCAAATAAATTTA	CAGTAGTGCAAATAAATTTA	0
CAGTAGTGCAAATAAATTTA	CAGTAGTGCAAATAAATTTA	0
TGGTTGTCTGTTATAAGGAC	TGGTTGTCTGGTAAAAGGAC	2
CGGACCCATCTTCAACGTTG	CGGAACCATCTTCAACGTTG	1
TGGATGTCTGGTAAAACGAC	TGGTTGTCTGGTAAAAGGAC	2
CCGATTGTCTCGACAGGTAA	CAGATTGTGTCGACAGGTAA	2
CAGGTGGTCACGCTTTTCGT	CATGTGGTCACGCTTTTCGT	1
AACGGACAGATTGTGTGGAC	AAAGGACAGATTGTGTCGAC	2
CACACTCAAGAAGGACCATG	CAAACTCAAGAAGGACCATG	1
GCGTTTCTGTACATAACTTT	GCGTTCCTGTACATAACCTT	2
TTGTAGTATTTCGTTGATAA	TTGGAGTATTTTGTTGATAA	2
CATGTGGCCACGCTTTTCGT	CATGTGGTCACGCTTTTCGT	1
TTAACTGGATACGAGTAACA	TTAACTCGATACGATTAACA	2
GTCGACAGGTAATGGTAGTC	GTCGACAGGTAATGGTTGTC	1
CGAACTCAAGAAGGACCATT	CAAACTCAAGAAGGACCATG	2
GTAGTGACAAGTGTTGCCCA	GTAGTGACAAGTGTTGGCCA	1
CAAGTGGGCACGCTTTTCGT	CATGTGGTCACGCTTTTCGT	2
AAAGGACAGATCGTGTCGAC	AAAGGACAGATTGTGTCGAC	1
GACTTCAGCACGCGTCTTTT	GACTTCAGCACGCGTCTTGT	1
CAGATTGTGTCGCCAAGTAA	CAGATTGTGTCGACAGGTAA	2
GTCAGAGTAGGGACAAGGGT	GTCAGAGTAGTGACAAGTGT	2
CATCTAATTCAACAAGAAGT	CATCTAATTCAACAAGAATT	1
CATCTAATTGAACAAGAATT	CATCTAATTCAACAAGAATT	1
CAGATTGTGTCGACAAGTAA	CAGATTGTGTCGACAGGTAA	1
CAAACTCAAGAACGACCTTG	CAAACTCAAGAAGGACCATG	2
AAAGGACAGATTGCGTCGAC	AAAGGACAGATTGTGTCGAC	1
GTCAGGGTAGTGAAAAGTGT	GTCAGAGTAGTGACAAGTGT	2
GGTTGTATGGTAAAAGGGCA	GGTTGTCTGGTAAAAGGACA	2
GTAGTGACAAGTGTTGTGCA	GTAGTGACAAGTGTTGGCCA	2
GTAGTGTCAAGTGTTGGCCA	GTAGTGACAAGTGTTGGCCA	1
CATCTAATTCAGCAAGAATT	CATCTAATTCAACAAGAATT	1
CAGATTGGGTCGACAGGTAA	CAGATTGTGTCGACAGGTAA	1
TAACTCGGTACGATTAACAA	TAACTCGATACGATTAACAA	1
CGAACTCAAGAAGGACCATG	CAAACTCAAGAAGGACCATG	1
GTCAGAGTAGTGACAAGCGT	GTCAGAGTAGTGACAAGTGT	1
ATGTGGTCACGCTTTTCGTA	ATGTGGTCACGCTTTTCGTT	1
CAGAACCATCTTCAACGTTG	CGGAACCATCTTCAACGTTG	1
CCATCTAATTCAACAAGAAG	CCATCTAATTCAACAAGAAT	1
ACAAGTGTTTGCCACGGAAC	ACAAGTGTTGGCCACGGAAC	1
GTAGTGCCAAGTGTTGGCCA	GTAGTGACAAGTGTTGGCCA	1
GGTAAGGGTTGTCGGGTAAA	GGTAATGGTTGTCTGGTAAA	2
TGGTCGTCTTGTAAAAGGAC	TGGTTGTCTGGTAAAAGGAC	2
CAGACTCAAGAAGGACCATG	CAAACTCAAGAAGGACCATG	1
CCATTTAATTCAATAAGAAT	CCATCTAATTCAACAAGAAT	2
GTAGTGACAAGTCTTGGCCA	GTAGTGACAAGTGTTGGCCA	1
ACAAGAGTTCGCCACGGAAC	ACAAGTGTTGGCCACGGAAC	2
CGGATCCTTCTTCAACGTTG	CGGAACCATCTTCAACGTTG	2
ATGTGGTAACGCTTTTCGTT	ATGTGGTCACGCTTTTCGTT	1
ACAAGTGTTGGCCACGGATC	ACAAGTGTTGGCCACGGAAC	1
TAGTTTGTGTCGACAGGTAA	CAGATTGTGTCGACAGGTAA	2
AAAGGACAGAGTGTGTCGAC	AAAGGACAGATTGTGTCGAC	1
CATCACCTTCACCCTCTCCC	CATCACCTTCACCCTCTCCA	1
GGAAAAGCATTGAACGCCAT	GGAAAAGCATTGAACACCAT	1
GGTTGTCTGGTACAAGGACA	GGTTGTCTGGTAAAAGGACA	1
AAAGGACAGATTCTGTCGAC	AAAGGACAGATTGTGTCGAC	1
AAGATTGTGTCGACAGGTAC	CAGATTGTGTCGACAGGTAA	2
GGAAAAGCATTGAACCCCAT	GGAAAAGCATTGAACACCAT	1
TTGTAGTATTTTGTTGACAA	TTGGAGTATTTTGTTGATAA	2
TTGGAGTATATTGTTGATAA	TTGGAGTATTTTGTTGATAA	1
CAAACTCAAGGAGGACCATT	CAAACTCAAGAAGGACCATG	2
TCACTCCGTTTCATGTGATC	TCATGCCGTTTCATGTGATC	2
GGTTGTATGGTAAAAGGACA	GGTTGTCTGGTAAAAGGACA	1
CAGTATTGCAAATCAATTTA	CAGTAGTGCAAATAAATTTA	2
TTAACTCGATACGATTGACA	TTAACTCGATACGATTAACA	1
ATTTCATGTGATTCGGATAA	GTTTCATGTGATCCGGATAA	2
TTTCGTTAGAATCTTTCGAA	TTTCGTTGGGATCTTTCGAA	2
CATTTCAGCACGCGTCTTGT	GACTTCAGCACGCGTCTTGT	2
AAAGGACATATTGTGCCGAC	AAAGGACAGATTGTGTCGAC	2
GGAGAAGCATTGGACACCAT	GGAAAAGCATTGAACACCAT	2
CAGTAGTGCAAATAAAGTTA	CAGTAGTGCAAATAAATTTA	1
ACAAGTGTTGGCCGCGGAAC	ACAAGTGTTGGCCACGGAAC	1
CAGCAGTTACAAACGCAAGA	CAGCAGTTACAAACTCAAGA	1
ATAATGGTCTGCTAACTGAA	ATAATGGTCTGCTAGTTGAA	2
TTTCGTTGGGATCTTTCGAC	TTTCGTTGGGATCTTTCGAA	1
AAAGGACGGATTGTGTCGAC	AAAGGACAGATTGTGTCGAC	1
ATAATGGCCTGCTAGTTAAA	ATAATGGTCTGCTAGTTGAA	2
TTTCATGTGATCCGGATTAC	TTTCATGTGATCCGGATAAC	1
ATGTGGTCACGCTTATCGTT	ATGTGGTCACGCTTTTCGTT	1
TAACTCGATACGATAAACAA	TAACTCGATACGATTAACAA	1
CAAACTCAACAAGGACCATG	CAAACTCAAGAAGGACCATG	1
TTTCATCTGATCCGGATAAC	TTTCATGTGATCCGGATAAC	1
CTGTACATACCCTTCGGGCC	CTGTACATAACCTTCGGGCA	2
TTTCGCTGGGATCTATCGAA	TTTCGTTGGGATCTTTCGAA	2
TGGTAGTCTGGTAAAAGGAC	TGGTTGTCTGGTAAAAGGAC	1
TCATGCCATCTCATGTGATC	TCATGCCGTTTCATGTGATC	2
CGATCCTGTAGATAACCTTC	CGTTCCTGTACATAACCTTC	2
ACAAGTGTTGACCACGCAAC	ACAAGTGTTGGCCACGGAAC	2
GCGTTCCTGCAAATAACCTT	GCGTTCCTGTACATAACCTT	2
GTAGCCAGGTAATGGTTGTC	GTCGACAGGTAATGGTTGTC	2
GGTTATCTGGTAAAAGGACA	GGTTGTCTGGTAAAAGGACA	1
GTCGACAGGTACTGGTTGTC	GTCGACAGGTAATGGTTGTC	1
CATCACATTCACCCTCTCCA	CATCACCTTCACCCTCTCCA	1
CGTTGTCTGGTAAAAGGACA	GGTTGTCTGGTAAAAGGACA	1
AAAAGTGTTGGCCACGGACC	ACAAGTGTTGGCCACGGAAC	2
TGGCTGTCTGGTAAATGGAC	TGGTTGTCTGGTAAAAGGAC	2
TAACTCGATACAATTAACAA	TAACTCGATACGATTAACAA	1
TTTCGTTGGGATCATTCGAA	TTTCGTTGGGATCTTTCGAA	1
CATCTAAGTCAACAAGAATT	CATCTAATTCAACAAGAATT	1
GTTGTGACAAGCGTTGGCCA	GTAGTGACAAGTGTTGGCCA	2
CTGTACATAATCTTCAGGCA	CTGTACATAACCTTCGGGCA	2
CATTAGTGCAAATAAATTTA	CAGTAGTGCAAATAAATTTA	1
CAGATTGTGTCGACAGATAG	CAGATTGTGTCGACAGGTAA	2
TTAACTCGACACGATTAACA	TTAACTCGATACGATTAACA	1
GCGTTCCTGTGCATAACCTT	GCGTTCCTGTACATAACCTT	1
CAGTAGTGCAAATAAATCTT	CAGTAGTGCAAATAAATTTA	2
CAGAGTGTGTCGACAGGTAA	CAGATTGTGTCGACAGGTAA	1
TTAACTCGGTACGATTAACA	TTAACTCGATACGATTAACA	1
AGCAGTGCAAATAAATTTAA	AGTAGTGCAAATAAATTTAA	1
CATCAGCTTCACCCTATCCA	CATCACCTTCACCCTCTCCA	2
CTGTACATAACCTACGGGCA	CTGTACATAACCTTCGGGCA	1
CTATCTCAAGAAGGACCATG	CAAACTCAAGAAGGACCATG	2
GGTAATGGTTGTCTGATAAA	GGTAATGGTTGTCTGGTAAA	1
TTTCATGTGATCCGGAGAAC	TTTCATGTGATCCGGATAAC	1
TCCTGCCGTTTCACGTGATC	TCATGCCGTTTCATGTGATC	2
TCATCTAATTGAACAAGAAT	CCATCTAATTCAACAAGAAT	2
AGTAGTGCAAATTGATTTAA	AGTAGTGCAAATAAATTTAA	2
CATCTGATTCAACAATAATT	CATCTAATTCAACAAGAATT	2
TCATGCCGTTTCATATGATC	TCATGCCGTTTCATGTGATC	1
CAGTAGTGCACATAAATTTA	CAGTAGTGCAAATAAATTTA	1
AAAGGGCAAATTGTGTCGAC	AAAGGACAGATTGTGTCGAC	2
ATGAAGTATTTTGTTGATAA	TTGGAGTATTTTGTTGATAA	2
GGTAATGGTTGTGCGGTAAA	GGTAATGGTTGTCTGGTAAA	2
ATAATGGTCTGCTAGTTGAC	ATAATGGTCTGCTAGTTGAA	1
GGAATAGCATAGAACACCAT	GGAAAAGCATTGAACACCAT	2
ATGTGGTCACGCTTTTCGTC	ATGTGGTCACGCTTTTCGTT	1
CATCACCTTCACCCTCTTCA	CATCACCTTCACCCTCTCCA	1
CGTTCCTGTACACAACCTTC	CGTTCCTGTACATAACCTTC	1
CAGCAGTTACAAAATCTAGA	CAGCAGTTACAAACTCAAGA	2
GTTTCCTGTGATCCGGATAG	GTTTCATGTGATCCGGATAA	2
AGGAGAGGGCCATCGGCAAT	AGGACAGGGCCATCGCCAAT	2
ATAATGGGCTGCTAGTTGTA	ATAATGGTCTGCTAGTTGAA	2
TCATGCCGTTTCACGTGATC	TCATGCCGTTTCATGTGATC	1
AGGACAGGGCCAGCGCCTAT	AGGACAGGGCCATCGCCAAT	2
CAAAGTCAAGAAGGACCGTG	CAAACTCAAGAAGGACCATG	2
ATGTGGTCAAGCTTTTCGTT	ATGTGGTCACGCTTTTCGTT	1
CATGTGGTCATGCTTTTCGC	CATGTGGTCACGCTTTTCGT	2
AGAATGGTCTGCTAGGTGAA	ATAATGGTCTGCTAGTTGAA	2
GTCAGAGTAGTGACAAGGGT	GTCAGAGTAGTGACAAGTGT	1
CAGCAGTTTCAAACTCAAGA	CAGCAGTTACAAACTCAAGA	1
ACAAGTGTTGGCCACGGAAC	ACAAGTGTTGGCCACGGAAC	0
ACAAGTGTTGGCCACGGAAC	ACAAGTGTTGGCCACGGAAC	0
ACAAGTGTTGGCCACGGAAC	ACAAGTGTTGGCCACGGAAC	0
ACAAGTGTTGGCCACGGAAC	ACAAGTGTTGGCCACGGAAC	0
CAACCTCAAGAAGGACCTTG	CAAACTCAAGAAGGACCATG	2
TGATGCCGTTTCATGGGATC	TCATGCCGTTTCATGTGATC	2
CATCTAATCCTACAAGAATT	CATCTAATTCAACAAGAATT	2
ACAATGGTCTACTAGTTGAA	ATAATGGTCTGCTAGTTGAA	2
AGGACAGGGCCATCCTCAAT	AGGACAGGGCCATCGCCAAT	2
GTCAGAGTAGTGACAATTGC	GTCAGAGTAGTGACAAGTGT	2
GTTTCATGTGATCCGTATAA	GTTTCATGTGATCCGGATAA	1
CATGTGCTCACGCTCTTCGT	CATGTGGTCACGCTTTTCGT	2
CATCACCCTCCCCCTCTCCA	CATCACCTTCACCCTCTCCA	2
AGGACAGGGCGATCGCCAAT	AGGACAGGGCCATCGCCAAT	1
TGGTTGTCTAGTAAAAGGAC	TGGTTGTCTGGTAAAAGGAC	1
TGGTTGTCTGGTAAGAGGAC	TGGTTGTCTGGTAAAAGGAC	1
ACAAGTATTCGCCACGGAAC	ACAAGTGTTGGCCACGGAAC	2
GCGTGCCTGTACATAACATT	GCGTTCCTGTACATAACCTT	2
CAGCAGTTACATACTCAAGA	CAGCAGTTACAAACTCAAGA	1
CTGTACATAAGCTTCGGGCA	CTGTACATAACCTTCGGGCA	1
CATCTAAGTCAACAAGCATT	CATCTAATTCAACAAGAATT	2
ACAAGTGTTGTCCACGGAAC	ACAAGTGTTGGCCACGGAAC	1
CAGTATTGCAAATAAATTTC	CAGTAGTGCAAATAAATTTA	2
TAACTCGATAGGATTAACAA	TAACTCGATACGATTAACAA	1
CAAACTTAAGAAGGGCCATG	CAAACTCAAGAAGGACCATG	2
TCATGCCGTTTCATGTTATC	TCATGCCGTTTCATGTGATC	1
ATGTGGCCACGCTTGTCGTT	ATGTGGTCACGCTTTTCGTT	2
GGCGACAGGTAATGGTTATC	GTCGACAGGTAATGGTTGTC	2
GTCAGAGTACTGACAAGTGT	GTCAGAGTAGTGACAAGTGT	1
CGTCTAATTCAACAAGAATT	CATCTAATTCAACAAGAATT	1
CAGTAGTGCAATTAAAGTTA	CAGTAGTGCAAATAAATTTA	2
GTTTCATGTGATCCGGATAT	GTTTCATGTGATCCGGATAA	1
TCATACCGTTTCATGTGATC	TCATGCCGTTTCATGTGATC	1
TTTCAAGTGATCCGGGTAAC	TTTCATGTGATCCGGATAAC	2
ACAAGTGTTGGCCACGGAAA	ACAAGTGTTGGCCACGGAAC	1
GCAGTTACAAGTGTTGGCCA	GTAGTGACAAGTGTTGGCCA	2
CAGATTGTGTCGACAGATCA	CAGATTGTGTCGACAGGTAA	2
GGAAAAGCATTGAACAGCAT	GGAAAAGCATTGAACACCAT	1
CAATCTAATTCAACGAGAAT	CCATCTAATTCAACAAGAAT	2
GACTTCAGAACGCGTCTTGT	GACTTCAGCACGCGTCTTGT	1
GTCAGAGTAGTGACAAGTGG	GTCAGAGTAGTGACAAGTGT	1
TTTACTCGATATGATTAACA	TTAACTCGATACGATTAACA	2
AGTAGTCCAAATAAATTCAA	AGTAGTGCAAATAAATTTAA	2
CCATCTAACTCAACAAGAAT	CCATCTAATTCAACAAGAAT	1
CATCACCTTCAGCCTATCCA	CATCACCTTCACCCTCTCCA	2
CCATCTAAGTCAACAAGAAT	CCATCTAATTCAACAAGAAT	1
GTGAACATAACCTTCGGGCA	CTGTACATAACCTTCGGGCA	2
CATATGGGCACGCTTTTCGT	CATGTGGTCACGCTTTTCGT	2
AGTAGTGCTAATTAATTTAA	AGTAGTGCAAATAAATTTAA	2
AAAGGACAGACTGTGTCGAC	AAAGGACAGATTGTGTCGAC	1
GTCAGCGTAGTGACAAGTGT	GTCAGAGTAGTGACAAGTGT	1
CGGAACTATCGTCAACGTTG	CGGAACCATCTTCAACGTTG	2
CATCTAATTCAAGAAGAATT	CATCTAATTCAACAAGAATT	1
CTGTACGTAACCCTCGGGCA	CTGTACATAACCTTCGGGCA	2
TGTCATTTGATCCGGATAAC	TTTCATGTGATCCGGATAAC	2
GACTTCAGCACTCGTCTTGT	GACTTCAGCACGCGTCTTGT	1
CAACAGTTACGAACTCAAGA	CAGCAGTTACAAACTCAAGA	2
CAGTATTGCAAATAAACTTA	CAGTAGTGCAAATAAATTTA	2
TCACACGATACGATTAACAA	TAACTCGATACGATTAACAA	2
AAGTAGTGTAAATAAATTTA	CAGTAGTGCAAATAAATTTA	2
GAATTCAGCACGCGTCTTGA	GACTTCAGCACGCGTCTTGT	2
GTTTCATGTGATCCGGATCA	GTTTCATGTGATCCGGATAA	1
CAGATTGTGTCGCCAGGTGA	CAGATTGTGTCGACAGGTAA	2
GGTTGTCTGGGAAAAGGAGA	GGTTGTCTGGTAAAAGGACA	2
CGGAACCATATTCAACGTTG	CGGAACCATCTTCAACGTTG	1
CACGTGGTCACGCTTTTCGT	CATGTGGTCACGCTTTTCGT	1
CAGCAGCTAGAAACTCAAGA	CAGCAGTTACAAACTCAAGA	2
GTCGACAGGTAAGGGTTGTT	GTCGACAGGTAATGGTTGTC	2
CAGAATATGTCGACAGGTAA	CAGATTGTGTCGACAGGTAA	2
TGGTTGTGTGGTAAACGGAC	TGGTTGTCTGGTAAAAGGAC	2
TTAACTCCATACGATTTACA	TTAACTCGATACGATTAACA	2
TTGGAGTATTTTGTTGATAT	TTGGAGTATTTTGTTGATAA	1
AGTAGTGCAAATAAGTTTAA	AGTAGTGCAAATAAATTTAA	1
AAAGGACAGATTGTGTCAAC	AAAGGACAGATTGTGTCGAC	1
AGTGGTGCAAATAAATTTAA	AGTAGTGCAAATAAATTTAA	1
TCATGCCGTTTAATGTGATC	TCATGCCGTTTCATGTGATC	1
GGAAAAGCATTGAACACCAG	GGAAAAGCATTGAACACCAT	1
GTCGACGGGTAATGATTGTC	GTCGACAGGTAATGGTTGTC	2
TGTAGTGCAAATAAAGTTAA	AGTAGTGCAAATAAATTTAA	2
GGTAATGGTTGTTTGGTAAA	GGTAATGGTTGTCTGGTAAA	1
GTCAGAGTAGTTACACGTGT	GTCAGAGTAGTGACAAGTGT	2
GTAGTGACCAGTGTTGGCCA	GTAGTGACAAGTGTTGGCCA	1
TTGGAGTACTTTGTTGATAA	TTGGAGTATTTTGTTGATAA	1
GACTTCATCACGTGTCTTGT	GACTTCAGCACGCGTCTTGT	2
GTAGTAACAAGTGCTGGCCA	GTAGTGACAAGTGTTGGCCA	2
GTAAAAGCATTGAGCACCAT	GGAAAAGCATTGAACACCAT	2
GTAGTGACAAGTGTGGGACA	GTAGTGACAAGTGTTGGCCA	2
AGTAGTGCAAATACCTTTAA	AGTAGTGCAAATAAATTTAA	2
GCTTTCCTGTACATAACCTT	GCGTTCCTGTACATAACCTT	1
CATAACCTGCACCCTCTCCA	CATCACCTTCACCCTCTCCA	2
CATGTCGTCACACTTTTCGT	CATGTGGTCACGCTTTTCGT	2
GTCAGATTAGAGACAAGTGT	GTCAGAGTAGTGACAAGTGT	2
CAGCAGTTACAAACAAAAGA	CAGCAGTTACAAACTCAAGA	2
ATAATGGTCTGCTAGTTAAA	ATAATGGTCTGCTAGTTGAA	1
CATCTAATGCAACAAGAATT	CATCTAATTCAACAAGAATT	1
TTTCGTGTGATCCGGATAAC	TTTCATGTGATCCGGATAAC	1
GTAGTAACAAGTGATGGCCA	GTAGTGACAAGTGTTGGCCA	2
CAGCAGCTATAAACTCAAGA	CAGCAGTTACAAACTCAAGA	2
GCGTGTCTGGTAAAAGGACA	GGTTGTCTGGTAAAAGGACA	2
GACTTCATCTCGCGTCTTGT	GACTTCAGCACGCGTCTTGT	2
GTCGACATGTAATGGGTGTC	GTCGACAGGTAATGGTTGTC	2
CTGATTGTGTCGAAAGGTAA	CAGATTGTGTCGACAGGTAA	2
GGTTTTCTGGTAAAAAGACA	GGTTGTCTGGTAAAAGGACA	2
GGTAATGGTTGTCTGGTCAA	GGTAATGGTTGTCTGGTAAA	1
ACAAGTATTGGGCACGGAAC	ACAAGTGTTGGCCACGGAAC	2
CACCAGTTACAAACCCAAGA	CAGCAGTTACAAACTCAAGA	2
CAGTAGTGCAAATTAATTTA	CAGTAGTGCAAATAAATTTA	1
CCATCTAATTCAGCAAGAAT	CCATCTAATTCAACAAGAAT	1
AAAATGGACTGCTAGTTGAA	ATAATGGTCTGCTAGTTGAA	2
CGTTCCTGTAAATAACCTTC	CGTTCCTGTACATAACCTTC	1
TTAACTCGATTCGATTAACT	TTAACTCGATACGATTAACA	2
CTCTACAGAACCTTCGGGCA	CTGTACATAACCTTCGGGCA	2
CAGATTGTGTCGACAGCTAA	CAGATTGTGTCGACAGGTAA	1
TCATACCGTTTCATGTGCTC	TCATGCCGTTTCATGTGATC	2
GACTTTAGCACTCGTCTTGT	GACTTCAGCACGCGTCTTGT	2
CGGAACCATCTTGAACGTTG	CGGAACCATCTTCAACGTTG	1
TCATGCCGTTCCATGTGCTC	TCATGCCGTTTCATGTGATC	2
CTGTACATAATCTGCGGGCA	CTGTACATAACCTTCGGGCA	2
CAAACTCAAGAAGGACGATG	CAAACTCAAGAAGGACCATG	1
ACAAGTGTTGGCCACGGAAT	ACAAGTGTTGGCCACGGAAC	1
TAACCCGATACGATTAACAA	TAACTCGATACGATTAACAA	1
CAGTAGTGCAGATAAATTTA	CAGTAGTGCAAATAAATTTA	1
GGAAAAGCATTTAACATCAT	GGAAAAGCATTGAACACCAT	2
GACTTCAGCACGCGTCTTGG	GACTTCAGCACGCGTCTTGT	1
CATCACCTTCACCGTCTCCA	CATCACCTTCACCCTCTCCA	1
CAGATTCTGTCGACTGGTAA	CAGATTGTGTCGACAGGTAA	2
CATGTGGTCACGCTTTTAGT	CATGTGGTCACGCTTTTCGT	1
CAAAAGTGCAAATAAATTTA	CAGTAGTGCAAATAAATTTA	2
CAGCAGTTACAAACACAAGA	CAGCAGTTACAAACTCAAGA	1
CAATCTAATTCCACAAGAAT	CCATCTAATTCAACAAGAAT	2
CAGCACCTTAACCCTCTCCA	CATCACCTTCACCCTCTCCA	2
AGTAGTGCAAATAAATTTAC	AGTAGTGCAAATAAATTTAA	1
GGAAAAGCATTGAACATCAT	GGAAAAGCATTGAACACCAT	1
AGTAATGCAAAAAAATTTAA	AGTAGTGCAAATAAATTTAA	2
AGTAGTGCACATAAATTTAA	AGTAGTGCAAATAAATTTAA	1
CAGCAGTTACAAAATCAAGA	CAGCAGTTACAAACTCAAGA	1
CCAAGTGGTGGCCACGGAAC	ACAAGTGTTGGCCACGGAAC	2
TGTCATGTGATCCGGATAAC	TTTCATGTGATCCGGATAAC	1
GTCAGAGTAGGGACAAGTGC	GTCAGAGTAGTGACAAGTGT	2
ACAAGTGTTGGCCACAGAAC	ACAAGTGTTGGCCACGGAAC	1
ATAACTTGATACGATTAACA	TTAACTCGATACGATTAACA	2
CAAACCCAAGAAGAACCATG	CAAACTCAAGAAGGACCATG	2
CGGAACCATGTTCAACGTTG	CGGAACCATCTTCAACGTTG	1
CAGTGGTGCAAATAATTTTA	CAGTAGTGCAAATAAATTTA	2
TTAACCCGTTACGATTAACA	TTAACTCGATACGATTAACA	2
CCATCTAATTCAACAAGCAT	CCATCTAATTCAACAAGAAT	1
AGTAGTGCAATTAAATTAAA	AGTAGTGCAAATAAATTTAA	2
CACTTCAGCACGCGTCTTGT	GACTTCAGCACGCGTCTTGT	1
GTCAGAGTCGTGACAAGGGT	GTCAGAGTAGTGACAAGTGT	2
TTTCGTTGGGATCTTTCGTG	TTTCGTTGGGATCTTTCGAA	2
GTCAGAGTATTGACAAGTGT	GTCAGAGTAGTGACAAGTGT	1
GGTAATGATTGTCTGGTAAA	GGTAATGGTTGTCTGGTAAA	1
GGTAATGGTTGTATGGCAAA	GGTAATGGTTGTCTGGTAAA	2
TCATGCCGTTTCCTGTGATC	TCATGCCGTTTCATGTGATC	1
TGGTTGTCTGGGAAAAGAAC	TGGTTGTCTGGTAAAAGGAC	2
CAGCAGTTACGAACTCAAGA	CAGCAGTTACAAACTCAAGA	1
TCATGCCGCTTCATGTGATC	TCATGCCGTTTCATGTGATC	1
TTCACTCGATACGATTAACA	TTAACTCGATACGATTAACA	1
TTGCATGTGAACCGGATAAC	TTTCATGTGATCCGGATAAC	2
GTCGTGACAAGTGTTGACCA	GTAGTGACAAGTGTTGGCCA	2
GTCGGAGTAGTGACAAGTGT	GTCAGAGTAGTGACAAGTGT	1
CGGAACCATCTGCAACGTAG	CGGAACCATCTTCAACGTTG	2
ATCGACAGGTAATGGTTATC	GTCGACAGGTAATGGTTGTC	2
CCATCAAATTCAATAAGAAT	CCATCTAATTCAACAAGAAT	2
GCGTTCCTCTTCATAACCTT	GCGTTCCTGTACATAACCTT	2
CGTTCCTGTACCCAACCTTC	CGTTCCTGTACATAACCTTC	2
ATAATGGTCTGCTCGTTGAA	ATAATGGTCTGCTAGTTGAA	1
CAGTAGTGCAAATAAATTTG	CAGTAGTGCAAATAAATTTA	1
CGTCCCTGTACATAACATTC	CGTTCCTGTACATAACCTTC	2
CTTCATGTGATCCGAATAAC	TTTCATGTGATCCGGATAAC	2
GTAGTGACATGTGTTGGCCA	GTAGTGACAAGTGTTGGCCA	1
CGGAACCATCTTCAACGTTT	CGGAACCATCTTCAACGTTG	1
GTAGTGACAAGTGTTGACCA	GTAGTGACAAGTGTTGGCCA	1
TAACTTGATACGATCAACAA	TAACTCGATACGATTAACAA	2
AAAGGACAGATTGAGTCGAC	AAAGGACAGATTGTGTCGAC	1
ATGTTGTCACGCTTTTCGTT	ATGTGGTCACGCTTTTCGTT	1
TGGTTGTCTGGGAAAAGGAC	TGGTTGTCTGGTAAAAGGAC	1
CAGTAGTGCAAATAAATTAA	CAGTAGTGCAAATAAATTTA	1
GTAGTCACAAGTGTTGGCCA	GTAGTGACAAGTGTTGGCCA	1
CCATCTAATTGAACAAGAAT	CCATCTAATTCAACAAGAAT	1
AGGACAGGGCCATCGCTAAT	AGGACAGGGCCATCGCCAAT	1
CAGTAGAGCAAATAAATTTA	CAGTAGTGCAAATAAATTTA	1
CAGCTGATACAAACTCAAGA	CAGCAGTTACAAACTCAAGA	2
GGTAATGGTTGTCTGCTAAA	GGTAATGGTTGTCTGGTAAA	1
TTTCATGTGATCCGGATAAC	TTTCATGTGATCCGGATAAC	0
TTTCATGTGATCCGGATAAC	TTTCATGTGATCCGGATAAC	0
TTTCATGTGATCCGGATAAC	TTTCATGTGATCCGGATAAC	0
TTTCATGTGATCCGGATAAC	TTTCATGTGATCCGGATAAC	0
GTAGTGACACGTGTTGGCCA	GTAGTGACAAGTGTTGGCCA	1
TAACTCGATCCGATTTACAA	TAACTCGATACGATTAACAA	2
AGCACAGGGCCATCGCCAAT	AGGACAGGGCCATCGCCAAT	1
CAAACTCAAGAACGACCATG	CAAACTCAAGAAGGACCATG	1
AGGACAAGGCCCTCGCCAAT	AGGACAGGGCCATCGCCAAT	2
CCATCTAATTCAACAATAAT	CCATCTAATTCAACAAGAAT	1
CAGTAGTGCAAACAAATTTA	CAGTAGTGCAAATAAATTTA	1
ATGTTGTCACGCTTTCCGTT	ATGTGGTCACGCTTTTCGTT	2
GGGAAAGCATTGAACACCAC	GGAAAAGCATTGAACACCAT	2
GTGGTGACAAGTGTTGGTCA	GTAGTGACAAGTGTTGGCCA	2
CATGTGGTCACCCTGTTCGT	CATGTGGTCACGCTTTTCGT	2
GTCGACATGTAATGGTTGTC	GTCGACAGGTAATGGTTGTC	1
ATGTGGTTACGCTTATCGTT	ATGTGGTCACGCTTTTCGTT	2
AAACGACAGATTGGGTCGAC	AAAGGACAGATTGTGTCGAC	2
ACATCTAATTCAACAACAAT	CCATCTAATTCAACAAGAAT	2
GTAGTGACAGGTGTTGGCCA	GTAGTGACAAGTGTTGGCCA	1
CAGATTGTGTAGACAGGTAA	CAGATTGTGTCGACAGGTAA	1
CCATCTAATTCAACAAGGAT	CCATCTAATTCAACAAGAAT	1
CAGTAGAACAAATAAATTTA	CAGTAGTGCAAATAAATTTA	2
GACTTCAGTACGCGTCTTGT	GACTTCAGCACGCGTCTTGT	1
TAACTCGATAAGATTAACAA	TAACTCGATACGATTAACAA	1
CATCTAACTCAAGAAGAATT	CATCTAATTCAACAAGAATT	2
GCGTTCCTGTACATCACCTT	GCGTTCCTGTACATAACCTT	1
CGGAACCACCTCCAACGTTG	CGGAACCATCTTCAACGTTG	2
ATAATGGTCTGCTAGTTTAA	ATAATGGTCTGCTAGTTGAA	1
AGGACAGGGCCATCGCCTAT	AGGACAGGGCCATCGCCAAT	1
TATCACCTTCACACTCTCCA	CATCACCTTCACCCTCTCCA	2
TTGGACTATTTTGTTGACAA	TTGGAGTATTTTGTTGATAA	2
GGAAAATCCTTGAACACCAT	GGAAAAGCATTGAACACCAT	2
CCATCTAAATCAACAAGAAT	CCATCTAATTCAACAAGAAT	1
TTTCATGTGATCCGTATAAC	TTTCATGTGATCCGGATAAC	1
ATAATGGTCTGATAGTTGAA	ATAATGGTCTGCTAGTTGAA	1
GGTTGTCTGGTAAAAGGTCA	GGTTGTCTGGTAAAAGGACA	1
GCGTTCCTGTACATAACCAT	GCGTTCCTGTACATAACCTT	1
TTTCATGTGACCCGGATAAC	TTTCATGTGATCCGGATAAC	1
AGGCCAGGGCCATCGCCAAT	AGGACAGGGCCATCGCCAAT	1
CCATCTAATTCAACACGAAT	CCATCTAATTCAACAAGAAT	1
CAGTATTGCAAATAGATTTA	CAGTAGTGCAAATAAATTTA	2
GACTTCAGCATGCGGCTTGT	GACTTCAGCACGCGTCTTGT	2
TTTCGTTGGCATCTTTCGAA	TTTCGTTGGGATCTTTCGAA	1
CAGCAGTTCCAAACTCAAGA	CAGCAGTTACAAACTCAAGA	1
CTGTACATCACCTTCGGGGA	CTGTACATAACCTTCGGGCA	2
ATAATGGTCTGCTAATTGAA	ATAATGGTCTGCTAGTTGAA	1
CCTCTAATTCAACAAGAGTT	CATCTAATTCAACAAGAATT	2
CATCACCTTCACCCGCTCCA	CATCACCTTCACCCTCTCCA	1
CGTTCCCGGACATAACCTTC	CGTTCCTGTACATAACCTTC	2
GCCAAAGTAGTGACAAGTGT	GTCAGAGTAGTGACAAGTGT	2
GGAAAAGCATTGAAAACCAT	GGAAAAGCATTGAACACCAT	1
GTCTTCCTGTACATAACCTT	GCGTTCCTGTACATAACCTT	2
GGAAAAGCATTAAACACCAT	GGAAAAGCATTGAACACCAT	1
TGGTAGGCTGGTAAAAGGAC	TGGTTGTCTGGTAAAAGGAC	2
AGGACAGGGCCCTCGCCAAT	AGGACAGGGCCATCGCCAAT	1
GACTTCAGCACGCGTGTTGT	GACTTCAGCACGCGTCTTGT	1
CCATCTAATTTAACAAGAAT	CCATCTAATTCAACAAGAAT	1
GTAGTGGCCAGTGTTGGCCA	GTAGTGACAAGTGTTGGCCA	2
CAGCTTGTGTCTACAGGTAA	CAGATTGTGTCGACAGGTAA	2
GGTTGTCTGGTCAAAAGACA	GGTTGTCTGGTAAAAGGACA	2
CAAACTCAAGAAGGACCAAG	CAAACTCAAGAAGGACCATG	1
AAAACTGAAGAAGGACCATG	CAAACTCAAGAAGGACCATG	2
AGTAGTGCAAATAAAATTAA	AGTAGTGCAAATAAATTTAA	1
GTCGACAGGTAATGATTGTC	GTCGACAGGTAATGGTTGTC	1
GGAAAAGCCTTGAACACCAT	GGAAAAGCATTGAACACCAT	1
CTGTACATAACCTTCGTACA	CTGTACATAACCTTCGGGCA	2
CGTTCCTGAACATAACCTTC	CGTTCCTGTACATAACCTTC	1
GACTTCAGCGCGCGTCTTGT	GACTTCAGCACGCGTCTTGT	1
CAGTAGTGCCAATAAATTTA	CAGTAGTGCAAATAAATTTA	1
GTTTCATGTGATTCGGACAA	GTTTCATGTGATCCGGATAA	2
AGTACTGCAAATAAATTTAA	AGTAGTGCAAATAAATTTAA	1
TCATCGAATTCAACAAGAAT	CCATCTAATTCAACAAGAAT	2
AGTAGTGCAGATAAATTTAA	AGTAGTGCAAATAAATTTAA	1
ACGTGGTCAGGCTTTTCGTT	ATGTGGTCACGCTTTTCGTT	2
GCTAATGGCTGTCTGGTAAA	GGTAATGGTTGTCTGGTAAA	2
GTCAGAGTAGTGACCAGTGT	GTCAGAGTAGTGACAAGTGT	1
TAACTCGATACGATGAACAA	TAACTCGATACGATTAACAA	1
GCTCGTTGGGATCTTTCGAA	TTTCGTTGGGATCTTTCGAA	2
AAAGGACAGATTGTGTTGAC	AAAGGACAGATTGTGTCGAC	1
TCATTCCGTTTCCTGTGATC	TCATGCCGTTTCATGTGATC	2
TAACTCCATACGATTGACAA	TAACTCGATACGATTAACAA	2
GGAAATCGTTGTCTGGTAAA	GGTAATGGTTGTCTGGTAAA	2
TTGGGTTGGGATCTTTCGAA	TTTCGTTGGGATCTTTCGAA	2
CGAACTCAAGAATGACCATG	CAAACTCAAGAAGGACCATG	2
GTTAATGCTTGTCTGGTAAA	GGTAATGGTTGTCTGGTAAA	2
TAACTCGATACGATTTACAA	TAACTCGATACGATTAACAA	1
CAGCGGTTACAAACTCAAGA	CAGCAGTTACAAACTCAAGA	1
CTGTACATAGCCTTCCGGCA	CTGTACATAACCTTCGGGCA	2
CATGTGGTCACTCTTTTCGT	CATGTGGTCACGCTTTTCGT	1
ATAATCGTCTGCTAGTTGAA	ATAATGGTCTGCTAGTTGAA	1
TTAACTCCATACGATGAACA	TTAACTCGATACGATTAACA	2
CAGCAGCTACAATCTCAAGA	CAGCAGTTACAAACTCAAGA	2
ATGTGGTCACGCTTTTCGGT	ATGTGGTCACGCTTTTCGTT	1
TTGGAGTATTTTGTTGAGAA	TTGGAGTATTTTGTTGATAA	1
TGGTTGTCTGGTAAACGGAC	TGGTTGTCTGGTAAAAGGAC	1
GTCAGAGTAGTGCCAAGTGT	GTCAGAGTAGTGACAAGTGT	1
TTTCGTTGGGATCTTTCAAA	TTTCGTTGGGATCTTTCGAA	1
GGTTGTCTGGTAAAACGACA	GGTTGTCTGGTAAAAGGACA	1
TTTCGATGGTATCTTTCGAA	TTTCGTTGGGATCTTTCGAA	2
ATGTGGTCACGCTGTTCTTT	ATGTGGTCACGCTTTTCGTT	2
CTGTAGATAACCTTCGGGCA	CTGTACATAACCTTCGGGCA	1
TTGGAGTATTTGGTTGATAA	TTGGAGTATTTTGTTGATAA	1
ATAATGGTCTGCTTGTTGAA	ATAATGGTCTGCTAGTTGAA	1
GAACAGTTACAAACTCAAGA	CAGCAGTTACAAACTCAAGA	2
GGTAGTGCAAATAAAATTAA	AGTAGTGCAAATAAATTTAA	2
CCATCGTATTCAACAAGAAT	CCATCTAATTCAACAAGAAT	2
TTTCTTTGGGATCTTTCGAA	TTTCGTTGGGATCTTTCGAA	1
GTCAACAGGTAATGGCTGTC	GTCGACAGGTAATGGTTGTC	2
GGTAAAGGTTGTCTGGTAAC	GGTAATGGTTGTCTGGTAAA	2
GCGCTCCTGTACATATCCTT	GCGTTCCTGTACATAACCTT	2
ATAATGGTCTGGTAGTTGAA	ATAATGGTCTGCTAGTTGAA	1
GACCTCAGCACGCGTCTTGT	GACTTCAGCACGCGTCTTGT	1
TTGGAGTATTTTGTTGCTAA	TTGGAGTATTTTGTTGATAA	1
ACCTGTGTTGGCCACGGAAC	ACAAGTGTTGGCCACGGAAC	2
CGATCCTGTACATAACCTTC	CGTTCCTGTACATAACCTTC	1
CTGTGCTCACGCTTTTCGTT	ATGTGGTCACGCTTTTCGTT	2
CGCTGTCTGGTAAAAGGACA	GGTTGTCTGGTAAAAGGACA	2
CATGTGGTCACGCTTTTCGG	CATGTGGTCACGCTTTTCGT	1
CAGATTGTGTCGACCGGTAA	CAGATTGTGTCGACAGGTAA	1
TTAACTCGATAGGATTAACA	TTAACTCGATACGATTAACA	1
GTGGAGTATTTTGTAGATAA	TTGGAGTATTTTGTTGATAA	2
CAGCAGTCACCAACTCAAGA	CAGCAGTTACAAACTCAAGA	2
CAGATTGTGTCGACACGTAA	CAGATTGTGTCGACAGGTAA	1
CAGCAGTTACAAACCTAAGA	CAGCAGTTACAAACTCAAGA	2
TTGGAGTATGTTTTTGATAA	TTGGAGTATTTTGTTGATAA	2
ACATCTCATTCAACAAGAAT	CCATCTAATTCAACAAGAAT	2
GCGTTCCTGTACAAAACCTT	GCGTTCCTGTACATAACCTT	1
CATCTAGTTCATCAAGAATT	CATCTAATTCAACAAGAATT	2
TGTTCCTGTACATAACCTTC	CGTTCCTGTACATAACCTTC	1
ATAATGGTCTGCCAGTTGGA	ATAATGGTCTGCTAGTTGAA	2
ATAATGGTCTGCTAGTTGCA	ATAATGGTCTGCTAGTTGAA	1
ATGCGGTCACGCTTTTCGTC	ATGTGGTCACGCTTTTCGTT	2
CAGTAGTGCAAATAAAATTA	CAGTAGTGCAAATAAATTTA	1
CGGAACCATCTTTAACGTTA	CGGAACCATCTTCAACGTTG	2
TTGGAGTCTTTTGTTAATAA	TTGGAGTATTTTGTTGATAA	2
GGAAAAGCATTGAACACCGT	GGAAAAGCATTGAACACCAT	1
TTCGAGTATTTTGTTGCTAA	TTGGAGTATTTTGTTGATAA	2
GGTAATTGTTGTGTGGTAAA	GGTAATGGTTGTCTGGTAAA	2
CCATCTAATTCAACAAGATT	CCATCTAATTCAACAAGAAT	1
GATTGTCTGGTAAAAGGACC	GGTTGTCTGGTAAAAGGACA	2
TTTCGTTGGGGTCTTTCGAA	TTTCGTTGGGATCTTTCGAA	1
TGCTTGTCTGGTAAAAGGAC	TGGTTGTCTGGTAAAAGGAC	1
AACGGACAGATTGTCTCGAC	AAAGGACAGATTGTGTCGAC	2
GACTTCAGCGGGCGTCTTGT	GACTTCAGCACGCGTCTTGT	2
ATACTGGTCTGCTGGTTGAA	ATAATGGTCTGCTAGTTGAA	2
TTTCGTTGGTATCTTTCGAA	TTTCGTTGGGATCTTTCGAA	1
TTTCATGTGATCCGAATAAC	TTTCATGTGATCCGGATAAC	1
GGGAATGGTTGTCTGGTAAA	GGTAATGGTTGTCTGGTAAA	1
AGTAGTGCAAGTAAATTTAA	AGTAGTGCAAATAAATTTAA	1
GTCTTCAGAACGCGTCTTGT	GACTTCAGCACGCGTCTTGT	2
GTTTCATGTGAGCCGGATAA	GTTTCATGTGATCCGGATAA	1
AAAGGACAGATTGTGTAGAC	AAAGGACAGATTGTGTCGAC	1
TCGTTGACTGGTAAAAGGAC	TGGTTGTCTGGTAAAAGGAC	2
TGTAGTGCAAATTAATTTAA	AGTAGTGCAAATAAATTTAA	2
GTAGTGACAAGTGTGGGCCA	GTAGTGACAAGTGTTGGCCA	1
GTCGACCGGTAGTGGTTGTC	GTCGACAGGTAATGGTTGTC	2
GTTTCATCTGATCCGGATGA	GTTTCATGTGATCCGGATAA	2
AAAGGACAGATTTTGTCGAC	AAAGGACAGATTGTGTCGAC	1
CAAACCCAAGAAAGACCATG	CAAACTCAAGAAGGACCATG	2
CAGTAAATAACCTTCGGGCA	CTGTACATAACCTTCGGGCA	2
GACTTCAGCACGCGTCTCGT	GACTTCAGCACGCGTCTTGT	1
AATCACCTTCACCCTCTCCA	CATCACCTTCACCCTCTCCA	1
GAGTAGTGGAAATAAATTTA	CAGTAGTGCAAATAAATTTA	2
TCATGCCGTTTTACGTGATC	TCATGCCGTTTCATGTGATC	2
CATCTCATTCAACAACAATT	CATCTAATTCAACAAGAATT	2
CATCTAATTCAACATGAATT	CATCTAATTCAACAAGAATT	1
CGGCACCATCTTCAACCTTG	CGGAACCATCTTCAACGTTG	2
TTTCGTTGGCACCTTTCGAA	TTTCGTTGGGATCTTTCGAA	2
CATGTCGTCACGCTTTTCGT	CATGTGGTCACGCTTTTCGT	1
ATAATGCTCTGCTAGTTGAC	ATAATGGTCTGCTAGTTGAA	2
CAGATTGTGTCGACATGTAA	CAGATTGTGTCGACAGGTAA	1
GTAGTGACAAGTGTTGGCAA	GTAGTGACAAGTGTTGGCCA	1
TATCATGCGATCCGGATAAC	TTTCATGTGATCCGGATAAC	2
GTTGTGACAAATGTTGGCCA	GTAGTGACAAGTGTTGGCCA	2
GTAGTGGCAAGTGTTGGTCA	GTAGTGACAAGTGTTGGCCA	2
GGAAAAGCATTGAACACCAT	GGAAAAGCATTGAACACCAT	0
GGAAAAGCATTGAACACCAT	GGAAAAGCATTGAACACCAT	0
GGAAAAGCATTGAACACCAT	GGAAAAGCATTGAACACCAT	0
GGAAAAGCATTGAACACCAT	GGAAAAGCATTGAACACCAT	0
TTGGAGAAATTTGTTGATAA	TTGGAGTATTTTGTTGATAA	2
GTCAGAGTAGAGACAAGTGT	GTCAGAGTAGTGACAAGTGT	1
TTTCGTTGGGAACTTTCGAA	TTTCGTTGGGATCTTTCGAA	1
GCGTTCCTGTACCTAACCTT	GCGTTCCTGTACATAACCTT	1
CAAAATCAAGATGGACCATG	CAAACTCAAGAAGGACCATG	2
CAGCAGTTACCAACTCAAGA	CAGCAGTTACAAACTCAAGA	1
GGTTGTCTGTTAAAACGACA	GGTTGTCTGGTAAAAGGACA	2
GACTTAAGCACGCGTCTTGT	GACTTCAGCACGCGTCTTGT	1
GACTTAAGCACGCGTCTTGC	GACTTCAGCACGCGTCTTGT	2
CAGATTGTGTCGACAGGTAA	CAGATTGTGTCGACAGGTAA	0
CAGATTGTGTCGACAGGTAA	CAGATTGTGTCGACAGGTAA	0
CAGATTGTGTCGACAGGTAA	CAGATTGTGTCGACAGGTAA	0
CAGATTGTGTCGACAGGTAA	CAGATTGTGTCGACAGGTAA	0
GTTTCGTCTGATCCGGATAA	GTTTCATGTGATCCGGATAA	2
TTGGAGTATTTTATTGATAA	TTGGAGTATTTTGTTGATAA	1
AGTGGTGCAAACAAATTTAA	AGTAGTGCAAATAAATTTAA	2
CGTTCCAGTACATAACCGTC	CGTTCCTGTACATAACCTTC	2
TGGGTGTCTGATAAAAGGAC	TGGTTGTCTGGTAAAAGGAC	2
CATCTAATTCACCATGAATT	CATCTAATTCAACAAGAATT	2
TTTTCATGTGATCCGCATAA	GTTTCATGTGATCCGGATAA	2
CGGAACCATCTTTAACGTTC	CGGAACCATCTTCAACGTTG	2
CAAACTCAAGTAGGACCATG	CAAACTCAAGAAGGACCATG	1
CATCACCTCCACCCTCTCCG	CATCACCTTCACCCTCTCCA	2
CAGTAGTGCAAATGAATTTA	CAGTAGTGCAAATAAATTTA	1
TAACTCGAAACGATTAAGAA	TAACTCGATACGATTAACAA	2
CATCACCTTCACCACCTCCA	CATCACCTTCACCCTCTCCA	2
CAGTAGTGCAAGTAAATTTA	CAGTAGTGCAAATAAATTTA	1
GGAAACGCATTGAACGCCAT	GGAAAAGCATTGAACACCAT	2
ATAATGGTCTGCTACTTTAA	ATAATGGTCTGCTAGTTGAA	2
AAACGACAGATTGTGTCGAG	AAAGGACAGATTGTGTCGAC	2
AGGAGAGGGCCATCGCCAAT	AGGACAGGGCCATCGCCAAT	1
CATCTAAATCAGCAAGAATT	CATCTAATTCAACAAGAATT	2
CATCACCTTCACGCTCTCCA	CATCACCTTCACCCTCTCCA	1
ATCATGGTCTGTTAGTTGAA	ATAATGGTCTGCTAGTTGAA	2
TCGTGCCGTTTCATGTGATC	TCATGCCGTTTCATGTGATC	1
AGTAGAGCAAATAAATTGAA	AGTAGTGCAAATAAATTTAA	2
CCATCTAATTCTCCAAGAAT	CCATCTAATTCAACAAGAAT	2
CATCTAATTCAACAAGAATG	CATCTAATTCAACAAGAATT	1
CAGTAATGCAAATAAATTGA	CAGTAGTGCAAATAAATTTA	2
AGTAGTGCAACTAAATTTAA	AGTAGTGCAAATAAATTTAA	1
TAACTCGCTACGATTTACAA	TAACTCGATACGATTAACAA	2
TTGGATTATTTAGTTGATAA	TTGGAGTATTTTGTTGATAA	2
GTAGTGACAAGAGTTGGCCA	GTAGTGACAAGTGTTGGCCA	1
CTGTACATAATCTTCGGACA	CTGTACATAACCTTCGGGCA	2
AAAGGACGGATTGTTTCGAC	AAAGGACAGATTGTGTCGAC	2
AGAAGTGCAAATAAATTTAA	AGTAGTGCAAATAAATTTAA	1
ATGTGGTCACGCTTTTGGTT	ATGTGGTCACGCTTTTCGTT	1
CAGCAGTTACTAACTCAAGA	CAGCAGTTACAAACTCAAGA	1
TTTCATGGGACCCGGATAAC	TTTCATGTGATCCGGATAAC	2
TTTCATGTTATCCGGATAAC	TTTCATGTGATCCGGATAAC	1
TCATGCCGTTTCATTTGCTC	TCATGCCGTTTCATGTGATC	2
CAAACTCAGGAAGGACCATG	CAAACTCAAGAAGGACCATG	1
TGGGACTATTTTGTTGATAA	TTGGAGTATTTTGTTGATAA	2
CGGTGTCTGGTAAAAGGACA	GGTTGTCTGGTAAAAGGACA	2
CATGTGGGCACGCTTTTCGC	CATGTGGTCACGCTTTTCGT	2
GGTTGTCTGGTAAAAGGACC	GGTTGTCTGGTAAAAGGACA	1
ACTAGTGCAAATATATTTAA	AGTAGTGCAAATAAATTTAA	2
TTTCGCTCGGATCTTTCGAA	TTTCGTTGGGATCTTTCGAA	2
GTCGACAGGTAATGGTTATC	GTCGACAGGTAATGGTTGTC	1
TTAACTCTATACAATTAACA	TTAACTCGATACGATTAACA	2
CAGATTGTGTCGACAGGTAG	CAGATTGTGTCGACAGGTAA	1
AGGACAGGGCCATTGGCAAT	AGGACAGGGCCATCGCCAAT	2
GGAACAGCATTGAACACCAC	GGAAAAGCATTGAACACCAT	2
CAGTGGTGCAAATAAATTTA	CAGTAGTGCAAATAAATTTA	1
CATCACCTTCAACCTCTCCA	CATCACCTTCACCCTCTCCA	1
TTGGAGTATCTTGTTGATAA	TTGGAGTATTTTGTTGATAA	1
CATCACCTTCACCGTCTCGA	CATCACCTTCACCCTCTCCA	2
AGGACAGGGCCATCGCCACT	AGGACAGGGCCATCGCCAAT	1
GACTTCAGCACGTGTCTTGT	GACTTCAGCACGCGTCTTGT	1
GTTTCATGTAATCCGGATAA	GTTTCATGTGATCCGGATAA	1
CGTTACGGTACATAACCTTC	CGTTCCTGTACATAACCTTC	2
TGGTTGTCTGGAATAAGGAC	TGGTTGTCTGGTAAAAGGAC	2
CAGATTGTGTCGACGGGTAA	CAGATTGTGTCGACAGGTAA	1
GCCTCCAGCACGCGTCTTGT	GACTTCAGCACGCGTCTTGT	2
TCAAGTGGTGGCCACGGAAC	ACAAGTGTTGGCCACGGAAC	2
ACAAGTGTTGGACACGGAAA	ACAAGTGTTGGCCACGGAAC	2
GACTTCAGCACGCGTCTTGT	GACTTCAGCACGCGTCTTGT	0
GACTTCAGCACGCGTCTTGT	GACTTCAGCACGCGTCTTGT	0
GACTTCAGCACGCGTCTTGT	GACTTCAGCACGCGTCTTGT	0
GACTTCAGCACGCGTCTTGT	GACTTCAGCACGCGTCTTGT	0
GCGTCCTTGTACATAACCTT	GCGTTCCTGTACATAACCTT	2
ATAGTGGTCTCCTAGTTGAA	ATAATGGTCTGCTAGTTGAA	2
TGGTTGTCAGGTAAAAGGAC	TGGTTGTCTGGTAAAAGGAC	1
TTTCATGTGATCCGGACAAC	TTTCATGTGATCCGGATAAC	1
CGTAACCATCATCAACGTTG	CGGAACCATCTTCAACGTTG	2
ATGTGGTCACGCCTTTCGTT	ATGTGGTCACGCTTTTCGTT	1
CGTTCCTGTACATAATCTTC	CGTTCCTGTACATAACCTTC	1
CATCTAATTCAACTAGAATT	CATCTAATTCAACAAGAATT	1
CAGATTGCGTCGACAGGTAA	CAGATTGTGTCGACAGGTAA	1
TTTCATGTGAGCCGAATAAC	TTTCATGTGATCCGGATAAC	2
ACAAGTGTCGGCCACGGAAC	ACAAGTGTTGGCCACGGAAC	1
AAAGGACAGATTATCTCGAC	AAAGGACAGATTGTGTCGAC	2
GTGGTGACACGTGTTGGCCA	GTAGTGACAAGTGTTGGCCA	2
CAAACTCTAGAAGGACCATG	CAAACTCAAGAAGGACCATG	1
CCATCTACTTCAACAAGAAT	CCATCTAATTCAACAAGAAT	1
CAAACTCAAGTAGGACCTTG	CAAACTCAAGAAGGACCATG	2
ACAAGTGCTGGCCACGGACC	ACAAGTGTTGGCCACGGAAC	2
CATCTTATTCAACAAGATTT	CATCTAATTCAACAAGAATT	2
CAGATTGTATAGACAGGTAA	CAGATTGTGTCGACAGGTAA	2
TCATGCCGTTTCATGTGACC	TCATGCCGTTTCATGTGATC	1
TTTCCTTGGGATCTTTCGAA	TTTCGTTGGGATCTTTCGAA	1
GTTTCATGTGATGCGGATAA	GTTTCATGTGATCCGGATAA	1
CAGTAGTGCAACTAAATTTA	CAGTAGTGCAAATAAATTTA	1
GTTTCATGTGATCCGGATTA	GTTTCATGTGATCCGGATAA	1
CCATGTAATTCAACGAGAAT	CCATCTAATTCAACAAGAAT	2
CTGTACATAACCTTCTGGCT	CTGTACATAACCTTCGGGCA	2
GGTAATGCTTGTCTGGTAAA	GGTAATGGTTGTCTGGTAAA	1
CAAACGCAAGAAGGACCATG	CAAACTCAAGAAGGACCATG	1
AGGACAGGGCCATCGCCCAT	AGGACAGGGCCATCGCCAAT	1
GTCGACAGGTAATGGTCGTC	GTCGACAGGTAATGGTTGTC	1
TTAACTCGATGCGATTAACC	TTAACTCGATACGATTAACA	2
CAGTGGTGCACATAAATTTA	CAGTAGTGCAAATAAATTTA	2
CCAACTAATTCAATAAGAAT	CCATCTAATTCAACAAGAAT	2
GATGTGGTCACGCTTTTCGT	CATGTGGTCACGCTTTTCGT	1
TGGTTGGATGGTAAAAGGAC	TGGTTGTCTGGTAAAAGGAC	2
AGCAGGGCAAATAAATTTAA	AGTAGTGCAAATAAATTTAA	2
TCATGCCTGTTCATGTGATC	TCATGCCGTTTCATGTGATC	2
GTAGTGACAAGTGTTGGCCA	GTAGTGACAAGTGTTGGCCA	0
GTAGTGACAAGTGTTGGCCA	GTAGTGACAAGTGTTGGCCA	0
GTAGTGACAAGTGTTGGCCA	GTAGTGACAAGTGTTGGCCA	0
GTAGTGACAAGTGTTGGCCA	GTAGTGACAAGTGTTGGCCA	0
TTTCGTCGGGATCTTTCTAA	TTTCGTTGGGATCTTTCGAA	2
TGGTTGACTAGTAAAAGGAC	TGGTTGTCTGGTAAAAGGAC	2
ACAAGTGTTGGCCACGTAAC	ACAAGTGTTGGCCACGGAAC	1
GTTTCATGTGATCCGAATAA	GTTTCATGTGATCCGGATAA	1
CATGTGTTCACGCTTTTTGT	CATGTGGTCACGCTTTTCGT	2
TAACTCGATACGAGTAACAA	TAACTCGATACGATTAACAA	1
CTTCATGTGATCCAGATAAC	TTTCATGTGATCCGGATAAC	2
CAGATTGTCTCGACAGATAA	CAGATTGTGTCGACAGGTAA	2
CAAACTCAAGAAGTACCATG	CAAACTCAAGAAGGACCATG	1
CATGTGGTCACGCGTTTCGA	CATGTGGTCACGCTTTTCGT	2
CCATCTAGTTCAACAGGAAT	CCATCTAATTCAACAAGAAT	2
GTCAGAGTAGTGACAAGTTT	GTCAGAGTAGTGACAAGTGT	1
TAACTCGAGACGATTAATAA	TAACTCGATACGATTAACAA	2
TTACATGTGATCCGGACAAC	TTTCATGTGATCCGGATAAC	2
TCATGCCGATTCATGTGATC	TCATGCCGTTTCATGTGATC	1
CAGATTGTGTGGACAGGGAA	CAGATTGTGTCGACAGGTAA	2
CAAGCTCAAGAAGGACCATG	CAAACTCAAGAAGGACCATG	1
TGGTGGTCTGGTAAAAGGAC	TGGTTGTCTGGTAAAAGGAC	1
CATCTAATTAAACATGAATT	CATCTAATTCAACAAGAATT	2
TGTAATGGTTGTCTGGTAAA	GGTAATGGTTGTCTGGTAAA	1
AGGAGTGCAAGTAAATTTAA	AGTAGTGCAAATAAATTTAA	2
TTTCATGTCATCCGGATAAC	TTTCATGTGATCCGGATAAC	1
TTTCGTTCGGATCTTTCGAA	TTTCGTTGGGATCTTTCGAA	1
TTGGAGTATTTTGTTAATAA	TTGGAGTATTTTGTTGATAA	1
AGTAGTGCAAAGAAATTTAA	AGTAGTGCAAATAAATTTAA	1
ATTAGTGCAACTAAATTTAA	AGTAGTGCAAATAAATTTAA	2
TCATGCCGTTTCATGTGTTG	TCATGCCGTTTCATGTGATC	2
GTGTGGTCACACTTTTCGTT	ATGTGGTCACGCTTTTCGTT	2
GTTTCATGTTATCCGTATAA	GTTTCATGTGATCCGGATAA	2
GTTTCATGTGTTCGGGATAA	GTTTCATGTGATCCGGATAA	2
GGTTGTCTGGTAAAAGCACA	GGTTGTCTGGTAAAAGGACA	1
CAGATTGTGTGGACAGGTAA	CAGATTGTGTCGACAGGTAA	1
CATGTGGTCACGTTTTTCGT	CATGTGGTCACGCTTTTCGT	1
GGTTGTCTAGTATAAGGACA	GGTTGTCTGGTAAAAGGACA	2
CAAACTCAAGAAGGACCATA	CAAACTCAAGAAGGACCATG	1
ATGTGTTCACGCTTTTCGTT	ATGTGGTCACGCTTTTCGTT	1
CGTTCCTCTACATAACCTTC	CGTTCCTGTACATAACCTTC	1
GGTTTTCTGGTAAAAGGACA	GGTTGTCTGGTAAAAGGACA	1
GTCAAAGTAGTGACAAGTGT	GTCAGAGTAGTGACAAGTGT	1
TGGTTGTTTGGCAAAAGGAC	TGGTTGTCTGGTAAAAGGAC	2
CAGATTGTTTTGACAGGTAA	CAGATTGTGTCGACAGGTAA	2
GACTTCAGCACGGGTCTTGT	GACTTCAGCACGCGTCTTGT	1
ATAATGGTCTTCTAGTTGAA	ATAATGGTCTGCTAGTTGAA	1
TTTCACGTGCTCCGGATAAC	TTTCATGTGATCCGGATAAC	2
TTTCATGTGAACCGGATAAC	TTTCATGTGATCCGGATAAC	1
GTAGTGAGAAGTGTTGGCCA	GTAGTGACAAGTGTTGGCCA	1
CGGAACCATCTTCCACGTTG	CGGAACCATCTTCAACGTTG	1
TGGAACCATCTTCAACGTTG	CGGAACCATCTTCAACGTTG	1
CATCACCTTCACCCTCTCCG	CATCACCTTCACCCTCTCCA	1
CCTTCTAATTCAACTAGAAT	CCATCTAATTCAACAAGAAT	2
TTCCGTTTGGATCTTTCGAA	TTTCGTTGGGATCTTTCGAA	2
CATCACCTTCACCTTCTCCA	CATCACCTTCACCCTCTCCA	1
GTTTCAAGTGATCCGGATAA	GTTTCATGTGATCCGGATAA	1
CGGAACCATCTTCAACGATG	CGGAACCATCTTCAACGTTG	1
GGTAATGGATGTCTGGTAAA	GGTAATGGTTGTCTGGTAAA	1
TTTCATGTGCTCCGGATAAC	TTTCATGTGATCCGGATAAC	1
GTTCGTTGGGATCTTTGGAA	TTTCGTTGGGATCTTTCGAA	2
CATCACCGTCACCCTCTACA	CATCACCTTCACCCTCTCCA	2
CTGTACATAAACTTCGGGCA	CTGTACATAACCTTCGGGCA	1
GACTTCAGCACGCGCCTTTT	GACTTCAGCACGCGTCTTGT	2
GCGTTCCTGTACATAAACTT	GCGTTCCTGTACATAACCTT	1
TTAACTCGATACGGTTAACA	TTAACTCGATACGATTAACA	1
TCATGCCGGTCCATGTGATC	TCATGCCGTTTCATGTGATC	2
AGTAGTGCTCATAAATTTAA	AGTAGTGCAAATAAATTTAA	2
CAGGATGTGTCGACAGGTAA	CAGATTGTGTCGACAGGTAA	2
GGTAATGGATTTCTGGTAAA	GGTAATGGTTGTCTGGTAAA	2
TAAACTCGATACGATTCACA	TTAACTCGATACGATTAACA	2
CGTAACCATCTTCAAGGTTG	CGGAACCATCTTCAACGTTG	2
ACAACTGTTGGCCACGGATC	ACAAGTGTTGGCCACGGAAC	2
CAGTAGTGCGAATAAATTTC	CAGTAGTGCAAATAAATTTA	2
TCGTTGTCTGGTAAAAGGAC	TGGTTGTCTGGTAAAAGGAC	1
GGAAAAACATTGAACATCAT	GGAAAAGCATTGAACACCAT	2
GTCTCATGTGATCCGGATAC	GTTTCATGTGATCCGGATAA	2
CGTTCCTGTACATAACCTGC	CGTTCCTGTACATAACCTTC	1
CATCTGATTCAAGAAGAATT	CATCTAATTCAACAAGAATT	2
GAGATTGTGTCGACAGGTAA	CAGATTGTGTCGACAGGTAA	1
GGTAAAGGGTGTCTGGTAAA	GGTAATGGTTGTCTGGTAAA	2
CCATCTAGTTCAAAAAGAAT	CCATCTAATTCAACAAGAAT	2
CGTTCCTGGACATAACTTTC	CGTTCCTGTACATAACCTTC	2
ATAGTGACAAGTGTTGACCA	GTAGTGACAAGTGTTGGCCA	2
TTGGAGAATTTTGCTGATAA	TTGGAGTATTTTGTTGATAA	2
GGAAAAGCATGGAACAGCAT	GGAAAAGCATTGAACACCAT	2
CTGTACATCACCTTCGGGCA	CTGTACATAACCTTCGGGCA	1
ACAAGTGTTAGCCACGGAAA	ACAAGTGTTGGCCACGGAAC	2
TAAATCGACACGATTAACAA	TAACTCGATACGATTAACAA	2
AGAACAGAGCCATCGCCAAT	AGGACAGGGCCATCGCCAAT	2
CAGCAGTGCAAATAAATTTA	CAGTAGTGCAAATAAATTTA	1
CAGTAGTGCAAATAACTTTA	CAGTAGTGCAAATAAATTTA	1
TGGTTGGCTGGTAAAAGGAC	TGGTTGTCTGGTAAAAGGAC	1
CAGATTGTGCCCACAGGTAA	CAGATTGTGTCGACAGGTAA	2
AGGACAGGGCCATCGACAAT	AGGACAGGGCCATCGCCAAT	1
CGTACCTGTACATAACCTTT	CGTTCCTGTACATAACCTTC	2
GTTTCGTGTGATCCGGATAG	GTTTCATGTGATCCGGATAA	2
CTGTACATAACCTTCGGGCC	CTGTACATAACCTTCGGGCA	1
CATGTAGTGACGCTTTTCGT	CATGTGGTCACGCTTTTCGT	2
CATGACCTTCACCCTCTCCA	CATCACCTTCACCCTCTCCA	1
CAGCATTTACAAACTCAACA	CAGCAGTTACAAACTCAAGA	2
CAGCAGGTACAAACACAAGA	CAGCAGTTACAAACTCAAGA	2
TCAACTCGATACGATAAACA	TTAACTCGATACGATTAACA	2
TTAACTCGATACGATTAGCA	TTAACTCGATACGATTAACA	1
ATGTACATAACCTTCGGGCA	CTGTACATAACCTTCGGGCA	1
GGTAATGGGTGTCAGGTAAA	GGTAATGGTTGTCTGGTAAA	2
GACTCCAGCACCCGTCTTGT	GACTTCAGCACGCGTCTTGT	2
CATGTGATCACGCTTTTCGT	CATGTGGTCACGCTTTTCGT	1
TAAACTCAAGAAGGACCATG	CAAACTCAAGAAGGACCATG	1
AGGACAGGGCCATCGCTAAG	AGGACAGGGCCATCGCCAAT	2
CCGTCTAATTCAACTAGAAT	CCATCTAATTCAACAAGAAT	2
TTAACTCGATACGATCAATA	TTAACTCGATACGATTAACA	2
CACCAGTAACAAACTCAAGA	CAGCAGTTACAAACTCAAGA	2
CGGAACCATCCTCAACGTTG	CGGAACCATCTTCAACGTTG	1
CTGTACATAACTTTCGGGCA	CTGTACATAACCTTCGGGCA	1
GCGTTCCTTTACATACCCTT	GCGTTCCTGTACATAACCTT	2
AAAGGACAGAGTATGTCGAC	AAAGGACAGATTGTGTCGAC	2
GTCGACAGGTAATCGTTGTC	GTCGACAGGTAATGGTTGTC	1
AAAGGACAGATTGTGACGAC	AAAGGACAGATTGTGTCGAC	1
CCATCTAATTCAACAAGAGT	CCATCTAATTCAACAAGAAT	1
GCGTTCCTATACATAACCTT	GCGTTCCTGTACATAACCTT	1
TTTCGTTGGGATCGTTCGAA	TTTCGTTGGGATCTTTCGAA	1
CATCTAGTGCAACAAGAATT	CATCTAATTCAACAAGAATT	2
TTAACTACATACGATTAACA	TTAACTCGATACGATTAACA	2
TCATGCCGTTTCATTTGTTC	TCATGCCGTTTCATGTGATC	2
GGTTGTCTGGTAAACGTACA	GGTTGTCTGGTAAAAGGACA	2
GGTAATGGTTGTCTGGTAAA	GGTAATGGTTGTCTGGTAAA	0
GGTAATGGTTGTCTGGTAAA	GGTAATGGTTGTCTGGTAAA	0
GGTAATGGTTGTCTGGTAAA	GGTAATGGTTGTCTGGTAAA	0
GGTAATGGTTGTCTGGTAAA	GGTAATGGTTGTCTGGTAAA	0
TAACTCGATCCGATAAACAA	TAACTCGATACGATTAACAA	2
AGGACAGTGCCATCGCCAAT	AGGACAGGGCCATCGCCAAT	1
ACAAATGTTGGCCACGGAAC	ACAAGTGTTGGCCACGGAAC	1
TGGTTGTTTGGTAAAAGGAC	TGGTTGTCTGGTAAAAGGAC	1
GTATCATGTGATCCGGAAAA	GTTTCATGTGATCCGGATAA	2
TTGGAGTGTTTTGTAGATAA	TTGGAGTATTTTGTTGATAA	2
GTTTCAAGTGATCCGGAGAA	GTTTCATGTGATCCGGATAA	2
GGTAATGGTTGTCTGGTAAT	GGTAATGGTTGTCTGGTAAA	1
TCATGCCGTTTCATGTGAAC	TCATGCCGTTTCATGTGATC	1
GGTTGTCTGGAAAAAGTACA	GGTTGTCTGGTAAAAGGACA	2
AGGACAGGGCCATAGCCAAG	AGGACAGGGCCATCGCCAAT	2
ATAATGGTGTGCTAGTTAAA	ATAATGGTCTGCTAGTTGAA	2
TCATGCCGTTTCATCTGATC	TCATGCCGTTTCATGTGATC	1
CAGAAGTTACGAACTCAAGA	CAGCAGTTACAAACTCAAGA	2
CATTAGTGCAAATAAATGTA	CAGTAGTGCAAATAAATTTA	2
AGTAGTGCAAATAAATTTAT	AGTAGTGCAAATAAATTTAA	1
CTGTACATAACCTTGGGGCA	CTGTACATAACCTTCGGGCA	1
CAGATTGTGACGACAGGTAA	CAGATTGTGTCGACAGGTAA	1
ATGTCGTCACGCTATTCGTT	ATGTGGTCACGCTTTTCGTT	2
TTTCGTTGGGAGCTTTCGAA	TTTCGTTGGGATCTTTCGAA	1
CATCACCTTCATCCTCTCCA	CATCACCTTCACCCTCTCCA	1
GACTTCAGCACGCGTATCGT	GACTTCAGCACGCGTCTTGT	2
CGTTCCCTTACATAACCTTC	CGTTCCTGTACATAACCTTC	2
CGGAACCATCTTCAACGGGG	CGGAACCATCTTCAACGTTG	2
TGGTTGTCTGGTAGAACGAC	TGGTTGTCTGGTAAAAGGAC	2
ATAAGGGTGTGCTAGTTGAA	ATAATGGTCTGCTAGTTGAA	2
TTGACTCCATACGATTAACA	TTAACTCGATACGATTAACA	2
GTTGCATGTGATCCGGATAA	GTTTCATGTGATCCGGATAA	1
TTACCTCGATACGAGTAACA	TTAACTCGATACGATTAACA	2
GCGTTCCTTTGCATAACCTT	GCGTTCCTGTACATAACCTT	2
TTTCATGTGATCCAGATAAG	TTTCATGTGATCCGGATAAC	2
TTAACTCGATACGGTTACCA	TTAACTCGATACGATTAACA	2
GTCGACAAGTAATAGTTGTC	GTCGACAGGTAATGGTTGTC	2
CAGCAGTCACAAACTCAAGA	CAGCAGTTACAAACTCAAGA	1
TCATGCCGTTTCATGTGAGC	TCATGCCGTTTCATGTGATC	1
GTAGTGACAAGTATTGGCAA	GTAGTGACAAGTGTTGGCCA	2
GTGTTCCTGTACAGAACCTT	GCGTTCCTGTACATAACCTT	2
GTCGACAGGTAATTGTCGTC	GTCGACAGGTAATGGTTGTC	2
CTCAGAGTAGTGACAAGTGT	GTCAGAGTAGTGACAAGTGT	1
GTTTCATTTGATCCGGATAG	GTTTCATGTGATCCGGATAA	2
GGTAATGGTAGTCTGGTAAA	GGTAATGGTTGTCTGGTAAA	1
ATGCGGTCACGCTTTTCCTT	ATGTGGTCACGCTTTTCGTT	2
TTTCGTTGGGATATTTCGAA	TTTCGTTGGGATCTTTCGAA	1
CAGCAGTTCCAAACTCAAGC	CAGCAGTTACAAACTCAAGA	2
CAGACTCAAGAAGGAGCATG	CAAACTCAAGAAGGACCATG	2
GGTTGCCTGGTAAAGGGACA	GGTTGTCTGGTAAAAGGACA	2
CAGTAGTGCAAATAAATCTA	CAGTAGTGCAAATAAATTTA	1
TTTCGTTGGGATCTTTGGAA	TTTCGTTGGGATCTTTCGAA	1
GCGCTCCTGTACGTAACCTT	GCGTTCCTGTACATAACCTT	2
CAGCAGTTACAAACTAAAGA	CAGCAGTTACAAACTCAAGA	1
AGAACCGGGCCATCGCCAAT	AGGACAGGGCCATCGCCAAT	2
GGTTGTCTGGTAAAAGGGCA	GGTTGTCTGGTAAAAGGACA	1
CTATACATAACCTTCGGGCA	CTGTACATAACCTTCGGGCA	1
CGTGTGTTCACGCTTTTCGT	CATGTGGTCACGCTTTTCGT	2
CAAACTCAAGAAAGACCATG	CAAACTCAAGAAGGACCATG	1
AGGACAGGGCCATCGCCAAT	AGGACAGGGCCATCGCCAAT	0
AGGACAGGGCCATCGCCAAT	AGGACAGGGCCATCGCCAAT	0
AGGACAGGGCCATCGCCAAT	AGGACAGGGCCATCGCCAAT	0
AGGACAGGGCCATCGCCAAT	AGGACAGGGCCATCGCCAAT	0
CAAACTCAAGGTGGACCATG	CAAACTCAAGAAGGACCATG	2
CCATCTAATTCAACAAGTAT	CCATCTAATTCAACAAGAAT	1
GGAAAAGCATTGCACACCAT	GGAAAAGCATTGAACACCAT	1
CAGATTGTTTCGATAGGTAA	CAGATTGTGTCGACAGGTAA	2
CAAATTCAAGAAGGACCATG	CAAACTCAAGAAGGACCATG	1
TTTCGTTGGGATCTTTCCAA	TTTCGTTGGGATCTTTCGAA	1
CAGTTGTGCAAATTAATTTA	CAGTAGTGCAAATAAATTTA	2
CATGTGGTCACGCTGTTCGT	CATGTGGTCACGCTTTTCGT	1
TGGTTGTCTCGCAAAAGGAC	TGGTTGTCTGGTAAAAGGAC	2
CATTTGGTCACGCGTTTCGT	CATGTGGTCACGCTTTTCGT	2
GCGTTCCTGGACATAACCTT	GCGTTCCTGTACATAACCTT	1
TAACTCGATTCGATTAACAA	TAACTCGATACGATTAACAA	1
CGTTCCTGTACATAACCTTG	CGTTCCTGTACATAACCTTC	1
TGTAATGGTTGTCTGGTACA	GGTAATGGTTGTCTGGTAAA	2
GTCAGAGTGGTGACTAGTGT	GTCAGAGTAGTGACAAGTGT	2
TTTCATGTGATCCCCATAAC	TTTCATGTGATCCGGATAAC	2
TTTCATGTGATCCCGATAAC	TTTCATGTGATCCGGATAAC	1
TATCACCTTCACCTTCTCCA	CATCACCTTCACCCTCTCCA	2
ATAAAGGTCTGCTAGATGAA	ATAATGGTCTGCTAGTTGAA	2
GGAAAAGCATTGAATACCAT	GGAAAAGCATTGAACACCAT	1
CTGTACTTAACCTTCGGGCA	CTGTACATAACCTTCGGGCA	1
CATCAACTTCACCCTCTGCA	CATCACCTTCACCCTCTCCA	2
AACTTCAGTACGCGTCTTGT	GACTTCAGCACGCGTCTTGT	2
CTATACATAACATTCGGGCA	CTGTACATAACCTTCGGGCA	2
GGTAATGTTTGTCTGGTAAA	GGTAATGGTTGTCTGGTAAA	1
GCGTTCCTGTACATAATGTT	GCGTTCCTGTACATAACCTT	2
TTTTGTTGGGATCTTTCGAA	TTTCGTTGGGATCTTTCGAA	1
ATAATGGTCTGCGAGTTGAA	ATAATGGTCTGCTAGTTGAA	1
TCATGCCGTTTCATGTAATC	TCATGCCGTTTCATGTGATC	1
GGTAATGGGTGTCTGGTAAA	GGTAATGGTTGTCTGGTAAA	1
GGTAATGGTTGTATGGTAAA	GGTAATGGTTGTCTGGTAAA	1
ATCGACAGGCAATGGTTGTC	GTCGACAGGTAATGGTTGTC	2
AGGACAGGGCCATCGCAAAT	AGGACAGGGCCATCGCCAAT	1
AAGTGGTCACGCTTTTCGTT	ATGTGGTCACGCTTTTCGTT	1
TAACTCGATACGGTTAACAA	TAACTCGATACGATTAACAA	1
ATAATCGTCTGCTAGTAGAA	ATAATGGTCTGCTAGTTGAA	2
CGGACAGGGCCTTCGCCAAT	AGGACAGGGCCATCGCCAAT	2
CTATCATGTGATCCGGATAA	GTTTCATGTGATCCGGATAA	2
TGGTTGTCTGGTAAAAGGTC	TGGTTGTCTGGTAAAAGGAC	1
CATCTAAATCAACAAGAAGT	CATCTAATTCAACAAGAATT	2
GTTAGAGTAGTGACAAGTGT	GTCAGAGTAGTGACAAGTGT	1
CAGTAGTGCAAATATATTTA	CAGTAGTGCAAATAAATTTA	1
AGGACACGGCCATCGCCAAT	AGGACAGGGCCATCGCCAAT	1
CGGAACCATCTCCAACGTTG	CGGAACCATCTTCAACGTTG	1
GGTTGCCTGGTAAAAGGACA	GGTTGTCTGGTAAAAGGACA	1
GGTTGTCTGGTAAAAGGCCA	GGTTGTCTGGTAAAAGGACA	1
TTGCATGTGACCCGGATAAC	TTTCATGTGATCCGGATAAC	2
GGTTATCAGGTAAAAGGACA	GGTTGTCTGGTAAAAGGACA	2
GACTTCAGCAAGCGTCTTGT	GACTTCAGCACGCGTCTTGT	1
AGGACTGGGCCATCGCCACT	AGGACAGGGCCATCGCCAAT	2
TTAACTCGATTCGACTAACA	TTAACTCGATACGATTAACA	2
TTGGAGTATTTGGTTGAGAA	TTGGAGTATTTTGTTGATAA	2
GTTTCATGCAATCCGGATAA	GTTTCATGTGATCCGGATAA	2
ACAAGTGTTGGCCGCCGAAC	ACAAGTGTTGGCCACGGAAC	2
GTTTCCTGTGATCCAGATAA	GTTTCATGTGATCCGGATAA	2
TAAGGACAGATTGTGTCCAC	AAAGGACAGATTGTGTCGAC	2
GACTTCAGCACGCGTCTTGA	GACTTCAGCACGCGTCTTGT	1
GGTTGTCTGGTAAAAAGACA	GGTTGTCTGGTAAAAGGACA	1
GACTACAGCACGTGTCTTGT	GACTTCAGCACGCGTCTTGT	2
AGCGACAGGTAATGGTTGTC	GTCGACAGGTAATGGTTGTC	2
AAAGGACAGATTGTTTCGAC	AAAGGACAGATTGTGTCGAC	1
GTTTCATGTGATCGGGATAA	GTTTCATGTGATCCGGATAA	1
TTTAGTGCAAATAAATTTAA	AGTAGTGCAAATAAATTTAA	2
GTAGTGACAAGTGTTCGCCG	GTAGTGACAAGTGTTGGCCA	2
TTTCGTCGGGATCTTTCGAA	TTTCGTTGGGATCTTTCGAA	1
GACTTCAGCACGTTTCTTGT	GACTTCAGCACGCGTCTTGT	2
GACTTCAGCACGCCTCTTGT	GACTTCAGCACGCGTCTTGT	1
AGTAGTGCAAATAAATCTAA	AGTAGTGCAAATAAATTTAA	1
TAACTGGATACGATTCACAA	TAACTCGATACGATTAACAA	2
CATCTAATTCAAGATGAATT	CATCTAATTCAACAAGAATT	2
TAACTCGATACGATTAATAA	TAACTCGATACGATTAACAA	1
AATGGCCAGATTGTGTCGAC	AAAGGACAGATTGTGTCGAC	2
CGTTCCTGTACCTAACCTTC	CGTTCCTGTACATAACCTTC	1
TAACTCTATACGATTAACAA	TAACTCGATACGATTAACAA	1
TTTCCTTGTGATCTTTCGAA	TTTCGTTGGGATCTTTCGAA	2
TTAACTCGATACGATTCCCA	TTAACTCGATACGATTAACA	2
TGATGCCGTTTCATGAGATC	TCATGCCGTTTCATGTGATC	2
AGTAGTGCAAATAATTTGAA	AGTAGTGCAAATAAATTTAA	2
AAAGGACAGATTGTGGCAAC	AAAGGACAGATTGTGTCGAC	2
TTGGAGTATTTTGTTGATAA	TTGGAGTATTTTGTTGATAA	0
TTGGAGTATTTTGTTGATAA	TTGGAGTATTTTGTTGATAA	0
TTGGAGTATTTTGTTGATAA	TTGGAGTATTTTGTTGATAA	0
TTGGAGTATTTTGTTGATAA	TTGGAGTATTTTGTTGATAA	0
GTGGACAGGTAATGGTTGTC	GTCGACAGGTAATGGTTGTC	1
GTAGTGACAAGTCTCGGCCA	GTAGTGACAAGTGTTGGCCA	2
CAAACACCAGAAGGACCATG	CAAACTCAAGAAGGACCATG	2
CAGGTTGTGTCGACAGGTAA	CAGATTGTGTCGACAGGTAA	1
AAAGGACAGATTGTGTCGAA	AAAGGACAGATTGTGTCGAC	1
GATTGTCTGGTAAAAGTACA	GGTTGTCTGGTAAAAGGACA	2
TTTCGTTCGGCTCTTTCGAA	TTTCGTTGGGATCTTTCGAA	2
TTTCATGGGATCAGGATAAC	TTTCATGTGATCCGGATAAC	2
GGAAAAGCATTGATCACCAC	GGAAAAGCATTGAACACCAT	2
CCAACTCAAGAAGGACCATG	CAAACTCAAGAAGGACCATG	1
TTTCATGTGATCCGGATGAC	TTTCATGTGATCCGGATAAC	1
CACCTAATTCAACAAGATTT	CATCTAATTCAACAAGAATT	2
TAACGCGCTACGATTAACAA	TAACTCGATACGATTAACAA	2
CATAACCTTCACCCTCTCCA	CATCACCTTCACCCTCTCCA	1
ACAAGTGTTGGCTACGGAAC	ACAAGTGTTGGCCACGGAAC	1
AGGACAGGGCCTTCGCCAAT	AGGACAGGGCCATCGCCAAT	1
GTGTACATAACCTTCGGGCA	CTGTACATAACCTTCGGGCA	1
TTAACTCGATGCGATTAACA	TTAACTCGATACGATTAACA	1
GTAGTGACAAGGGTTGGCGA	GTAGTGACAAGTGTTGGCCA	2
TTTCGTTAGGATCTATCGAA	TTTCGTTGGGATCTTTCGAA	2
CAGCAGTTACAAACTCGAGA	CAGCAGTTACAAACTCAAGA	1
CAGCAGATACAAACTCAAGA	CAGCAGTTACAAACTCAAGA	1
CATGTGGTCACGCTTTTCAT	CATGTGGTCACGCTTTTCGT	1
GCGTTCCTGTACATAACCTA	GCGTTCCTGTACATAACCTT	1
AGTAGTGCAAATAAATTGAA	AGTAGTGCAAATAAATTTAA	1
AGTAGTGCAAATCAATTTAA	AGTAGTGCAAATAAATTTAA	1
TTAACTCGATACGATTAATA	TTAACTCGATACGATTAACA	1
TTCACTCGATACGATTAAAA	TTAACTCGATACGATTAACA	2
TTAACTCGATACGCTTAACA	TTAACTCGATACGATTAACA	1
CAAACTCACGAAGGACCATG	CAAACTCAAGAAGGACCATG	1
TAACTCGATGCGATTAACAA	TAACTCGATACGATTAACAA	1
TCATGCCGTTTCATTTGATG	TCATGCCGTTTCATGTGATC	2
GTAATGGTCTGCTAGTTGAA	ATAATGGTCTGCTAGTTGAA	1
TGGTTGTCTGGTAGAAGGAC	TGGTTGTCTGGTAAAAGGAC	1
GGGACAGGGCCATCGCCCAT	AGGACAGGGCCATCGCCAAT	2
CAGATGGTGTCGATAGGTAA	CAGATTGTGTCGACAGGTAA	2
CGGAACCATTTTCAACGTTG	CGGAACCATCTTCAACGTTG	1
CAGCAGTTACACACTCAAGA	CAGCAGTTACAAACTCAAGA	1
CTGTACATAACCTTCGTGCA	CTGTACATAACCTTCGGGCA	1
CCATCGAATTCAACAACAAT	CCATCTAATTCAACAAGAAT	2
CATGTAGTCATGCTTTTCGT	CATGTGGTCACGCTTTTCGT	2
GTCGACAGGTAATGGTTCTC	GTCGACAGGTAATGGTTGTC	1
AGGACAGGGACATCGCCAAT	AGGACAGGGCCATCGCCAAT	1
GGTTGTCTCGTAAAAGGACA	GGTTGTCTGGTAAAAGGACA	1
CTGTACATATCCTTCGGGCA	CTGTACATAACCTTCGGGCA	1
TTAACTCGATAAGATTAACA	TTAACTCGATACGATTAACA	1
AGTAGTGCAAATAAATTAAA	AGTAGTGCAAATAAATTTAA	1
CATCACCTTGACCCTGTCCA	CATCACCTTCACCCTCTCCA	2
TTAACTCTATACGATTTACA	TTAACTCGATACGATTAACA	2
GTCAGAGTAGTGACAAGTAT	GTCAGAGTAGTGACAAGTGT	1
GACTTCAGCACGCGTCTCCT	GACTTCAGCACGCGTCTTGT	2
GACTTCAGCACGCATGTTGT	GACTTCAGCACGCGTCTTGT	2
TCATGCCGTTATATGTGATC	TCATGCCGTTTCATGTGATC	2
GGTAAAGCATTGAACACCAT	GGAAAAGCATTGAACACCAT	1
CGTTCCTGTACGTAACCGTC	CGTTCCTGTACATAACCTTC	2
CAGCAGTTACAAGCTCAAGA	CAGCAGTTACAAACTCAAGA	1
CAGTAGTGAAAATAAATTTA	CAGTAGTGCAAATAAATTTA	1
GGTTGTCTGGTGAAAGGACA	GGTTGTCTGGTAAAAGGACA	1
CATCACCCTCTCCCTCTCCA	CATCACCTTCACCCTCTCCA	2
CAGTAGTGCAAATCAATTTA	CAGTAGTGCAAATAAATTTA	1
AAAGGAGAGATTCTGTCGAC	AAAGGACAGATTGTGTCGAC	2
CAGCAGTTACAAACCCAAGA	CAGCAGTTACAAACTCAAGA	1
GTTTCATGTGATCCGGATAC	GTTTCATGTGATCCGGATAA	1
CCATCTAATTCAACAAGAAA	CCATCTAATTCAACAAGAAT	1
AAAGGACAGATTGTGTAAAC	AAAGGACAGATTGTGTCGAC	2
CGAACTCAAGAAAGACCATG	CAAACTCAAGAAGGACCATG	2
CAGCAGTTACAAACTCAAGG	CAGCAGTTACAAACTCAAGA	1
AGGACAGGGCCATCACCAAT	AGGACAGGGCCATCGCCAAT	1
GTGTGGCCACGCTTTTCGTT	ATGTGGTCACGCTTTTCGTT	2
CGTTCCTGTACATACCCATC	CGTTCCTGTACATAACCTTC	2
TCTGATGTGATCCGGATAAC	TTTCATGTGATCCGGATAAC	2
GTCGACAGGTAGTGGTTGTC	GTCGACAGGTAATGGTTGTC	1
ATAATGGTCTCCTAGTTGAA	ATAATGGTCTGCTAGTTGAA	1
CAGATTGTGTCCACAGGTAA	CAGATTGTGTCGACAGGTAA	1
TTAACTCGATACGTTTAAGA	TTAACTCGATACGATTAACA	2
TAGTACATAACCTTCGGGCA	CTGTACATAACCTTCGGGCA	2
TTTCGTTGTGATCTTTCGAA	TTTCGTTGGGATCTTTCGAA	1
CAGATTGTGTCGAGAGGCAA	CAGATTGTGTCGACAGGTAA	2
TCATGCCGTTGCATGTGATC	TCATGCCGTTTCATGTGATC	1
TTTCATGTGTTCCGGATAAC	TTTCATGTGATCCGGATAAC	1
CAGAGTGTGTCGATAGGTAA	CAGATTGTGTCGACAGGTAA	2
CGTTTCTGTACATGACCTTC	CGTTCCTGTACATAACCTTC	2
TTAACTTGATACGATTAACA	TTAACTCGATACGATTAACA	1
GTCAGAGTAGTGCCAAGTGC	GTCAGAGTAGTGACAAGTGT	2
GGTTGTCTGGTAAAAGGATA	GGTTGTCTGGTAAAAGGACA	1
TTAACTCGATACGATAAACC	TTAACTCGATACGATTAACA	2
CATGTGGTCACACTTATCGT	CATGTGGTCACGCTTTTCGT	2
CATCACTTTCAGCCTCTCCA	CATCACCTTCACCCTCTCCA	2
CATATTGTGTAGACAGGTAA	CAGATTGTGTCGACAGGTAA	2
CAGATTGTGTCGACAGGTGA	CAGATTGTGTCGACAGGTAA	1
TCATGCCGTTTCATGTGGTC	TCATGCCGTTTCATGTGATC	1
GGAAAAGCATAGAAGACCAT	GGAAAAGCATTGAACACCAT	2
TTTCGTTTGCATCTTTCGAA	TTTCGTTGGGATCTTTCGAA	2
GGTAATGGTTGCCTGGTAAA	GGTAATGGTTGTCTGGTAAA	1
TCATGCCAATTCATGTGATC	TCATGCCGTTTCATGTGATC	2
CATCTAATTCAACAAGTATT	CATCTAATTCAACAAGAATT	1
CATCAGCTTCACCGTCTCCA	CATCACCTTCACCCTCTCCA	2
GGTAATGGTTATCTGGTAAA	GGTAATGGTTGTCTGGTAAA	1
AAAGGACAGATTGTGTCGGC	AAAGGACAGATTGTGTCGAC	1
TTAACTCGATCCGATTAACA	TTAACTCGATACGATTAACA	1
CGGAGCCATCTTCTACGTTG	CGGAACCATCTTCAACGTTG	2
GGTTGCCTGGTAAAAGGAGA	GGTTGTCTGGTAAAAGGACA	2
TCATGCCGTTTGATGTGTTC	TCATGCCGTTTCATGTGATC	2
TCGTTCCTGTACATAACCTG	GCGTTCCTGTACATAACCTT	2
ATGTGGTCACTCTTTTCGTT	ATGTGGTCACGCTTTTCGTT	1
CATCATCTTCACCCTCTCCA	CATCACCTTCACCCTCTCCA	1
TATCTAATCCAACAAGAATT	CATCTAATTCAACAAGAATT	2
CTTCGTTGTGATCTTTCGAA	TTTCGTTGGGATCTTTCGAA	2
GGAAAAGCATTGAACACGAT	GGAAAAGCATTGAACACCAT	1
TTAACTCGATTCGATTAACA	TTAACTCGATACGATTAACA	1
GAGCTCCTGTACATAACCTT	GCGTTCCTGTACATAACCTT	2
GCGTTTCTGTACATGACCTT	GCGTTCCTGTACATAACCTT	2
CATCACCTTCACTCTCTCCA	CATCACCTTCACCCTCTCCA	1
CAAACTAAAGAAGGACCATG	CAAACTCAAGAAGGACCATG	1
CTGCACATAACCTTCGGGCA	CTGTACATAACCTTCGGGCA	1
GGTAATGGTTCTCTGGTAAA	GGTAATGGTTGTCTGGTAAA	1
CGTCTAATTAAACAAGAATT	CATCTAATTCAACAAGAATT	2
TAATGCCTTTTCATGTGATC	TCATGCCGTTTCATGTGATC	2
AAAGGACAGATTGTGTCGAG	AAAGGACAGATTGTGTCGAC	1
CCATCTAATTCAACTAGAAT	CCATCTAATTCAACAAGAAT	1
AGGTTGTATGGTAAAAGGAC	TGGTTGTCTGGTAAAAGGAC	2
GTCAGAGTAGTGACAAGTCT	GTCAGAGTAGTGACAAGTGT	1
ATAATGGTCTGCTGGGTGAA	ATAATGGTCTGCTAGTTGAA	2
CATGTGGTCACTCTTTCCGT	CATGTGGTCACGCTTTTCGT	2
GTCGACAGGTAAGGGTTGTC	GTCGACAGGTAATGGTTGTC	1
GCGTTCAAGTACATAACCTT	GCGTTCCTGTACATAACCTT	2
CCCTCTAATGCAACAAGAAT	CCATCTAATTCAACAAGAAT	2
GTTTCATGTGTTCCGGATAA	GTTTCATGTGATCCGGATAA	1
CCATCTAATTCAACAAAAAT	CCATCTAATTCAACAAGAAT	1
GCCAGAGTAGTGACAAGTGT	GTCAGAGTAGTGACAAGTGT	1
GGATAACCATTGAACACCAT	GGAAAAGCATTGAACACCAT	2
ATAATGGTCTGTTAGTTGAA	ATAATGGTCTGCTAGTTGAA	1
CCATCTAATTTAATAAGAAT	CCATCTAATTCAACAAGAAT	2
GTCGACAGGTAATGGTTGGC	GTCGACAGGTAATGGTTGTC	1
ATAATGCTCTGCTAGTTGAA	ATAATGGTCTGCTAGTTGAA	1
ATAATGGTCCGCTACTTGAA	ATAATGGTCTGCTAGTTGAA	2
GTAGTGACGAGAGTTGGCCA	GTAGTGACAAGTGTTGGCCA	2
AAAGGACAGATTGTGGCGAC	AAAGGACAGATTGTGTCGAC	1
GGTAATGCTTGTCGGGTAAA	GGTAATGGTTGTCTGGTAAA	2
CCATCTAATTCAACCAGAAT	CCATCTAATTCAACAAGAAT	1
GGTAATGGTTGACTGGTAAA	GGTAATGGTTGTCTGGTAAA	1
TTACAAGTGATCCGGATAAC	TTTCATGTGATCCGGATAAC	2
GGTTGTCTGGTAGAAGGACA	GGTTGTCTGGTAAAAGGACA	1
GTCAGAGTAGTGATAAGTGT	GTCAGAGTAGTGACAAGTGT	1
CTGTAGTGCAAATCAATTTA	CAGTAGTGCAAATAAATTTA	2
CGTTCCTGTACATACCCTTC	CGTTCCTGTACATAACCTTC	1
CCCTCTAATTCAATAAGAAT	CCATCTAATTCAACAAGAAT	2
TTTCATGTGATCCGGATAAA	TTTCATGTGATCCGGATAAC	1
GGTAATGGTTGTCTGGTAAC	GGTAATGGTTGTCTGGTAAA	1
CGGAACAATCTTCTACGTTG	CGGAACCATCTTCAACGTTG	2
AAAGGACAGATTGTGTGGAC	AAAGGACAGATTGTGTCGAC	1
CACATTGTGTCGACGGGTAA	CAGATTGTGTCGACAGGTAA	2
CAGCAGTTACCATCTCAAGA	CAGCAGTTACAAACTCAAGA	2
CGTTCGTGTACATGACCTTC	CGTTCCTGTACATAACCTTC	2
GTCGCCAGGTCATGGTTGTC	GTCGACAGGTAATGGTTGTC	2
GGAAAAGTATTGAACAACAT	GGAAAAGCATTGAACACCAT	2
ACAAGTGGTGGCCACGGAAC	ACAAGTGTTGGCCACGGAAC	1
CAAACTCAAGAAGGGCCATG	CAAACTCAAGAAGGACCATG	1
CATCACCTTCACCCTCTACA	CATCACCTTCACCCTCTCCA	1
CTGTACATTAACTTCGGGCA	CTGTACATAACCTTCGGGCA	2
CAGTTGTGCAAATACATTTA	CAGTAGTGCAAATAAATTTA	2
TGGTTGTCTGGTCAAAGGAC	TGGTTGTCTGGTAAAAGGAC	1
CTGCAGTGCAAATAAATTTA	CAGTAGTGCAAATAAATTTA	2
CAGTAGTGCTAATAAATTTA	CAGTAGTGCAAATAAATTTA	1
TAACTCGATACTATTAACAA	TAACTCGATACGATTAACAA	1
GGAAAAGCATTGACCACCAT	GGAAAAGCATTGAACACCAT	1
AGTAGTGCAAATGAATTTAA	AGTAGTGCAAATAAATTTAA	1
AGAGGACAGATTGTGCCGAC	AAAGGACAGATTGTGTCGAC	2
CGGAACCAGCTTCAACGTTG	CGGAACCATCTTCAACGTTG	1
TTTCATGCGATCCGGATAAC	TTTCATGTGATCCGGATAAC	1
GGGTTCGTGTACATAACCTT	GCGTTCCTGTACATAACCTT	2
ATGTGGTCAGGCTTTTCGTT	ATGTGGTCACGCTTTTCGTT	1
CGTTGTCTGGTAAAAGGTCA	GGTTGTCTGGTAAAAGGACA	2
CATCTAGTTCAACCAGAATT	CATCTAATTCAACAAGAATT	2
GTCGACAGGTAATGGTTGTA	GTCGACAGGTAATGGTTGTC	1
TTTCATGTGATCCGGTTAAC	TTTCATGTGATCCGGATAAC	1
ATAATGGTGTGCTAGTTGAA	ATAATGGTCTGCTAGTTGAA	1
AGTAGTGCAAATAAATTCAA	AGTAGTGCAAATAAATTTAA	1
GGAAAAGCATTGAAGACCAT	GGAAAAGCATTGAACACCAT	1
CAAACTCAAAAAGGACCATG	CAAACTCAAGAAGGACCATG	1
TCTTGCCGTTTCATGTGATC	TCATGCCGTTTCATGTGATC	1
GCTAATGGTTGTCTGTTAAA	GGTAATGGTTGTCTGGTAAA	2
TTGGAGTATTTTGTTTATAA	TTGGAGTATTTTGTTGATAA	1
TGGTTGTGTGGTAAAAGGAC	TGGTTGTCTGGTAAAAGGAC	1
GGGAATGCATTGAACACCAT	GGAAAAGCATTGAACACCAT	2
AGGAGAGCAAATAAATTTAA	AGTAGTGCAAATAAATTTAA	2
CATATGGTCACGCTTTTCGT	CATGTGGTCACGCTTTTCGT	1
GACTTTAGGACGCGTCTTGT	GACTTCAGCACGCGTCTTGT	2
CATCACCTTAACCCTCTCCA	CATCACCTTCACCCTCTCCA	1
GTGGACAGGTAAAGGTTGTC	GTCGACAGGTAATGGTTGTC	2
CAGTAATGCATATAAATTTA	CAGTAGTGCAAATAAATTTA	2
GTAGTGACAAATGTTGGCCA	GTAGTGACAAGTGTTGGCCA	1
ATGTTGTCACGCTTTTCGGT	ATGTGGTCACGCTTTTCGTT	2
GTAGTGACAAGTGTTGGCGA	GTAGTGACAAGTGTTGGCCA	1
CGTGCCTGTACATCACCTTC	CGTTCCTGTACATAACCTTC	2
TAACTCAATACGATTAACAA	TAACTCGATACGATTAACAA	1
CCATCTAATTCAACGAGAAT	CCATCTAATTCAACAAGAAT	1
CAATAGTGCAAATAAATTTA	CAGTAGTGCAAATAAATTTA	1
GGCAATGGTTGTCTGGTAGA	GGTAATGGTTGTCTGGTAAA	2
ATAATGGTCCGCTAGTTGAA	ATAATGGTCTGCTAGTTGAA	1
CAGATTGTATCGACAGGTAA	CAGATTGTGTCGACAGGTAA	1
TCATGCCGTTCCATGTGATC	TCATGCCGTTTCATGTGATC	1
GGTAATGGTTTACTGGTAAA	GGTAATGGTTGTCTGGTAAA	2
TTGGAGTATTTTGTCGATAA	TTGGAGTATTTTGTTGATAA	1
GGTTCATCTGATCCGGATAA	GTTTCATGTGATCCGGATAA	2
CATCACCTTCACCCTGTCCG	CATCACCTTCACCCTCTCCA	2
CCATGCCGTTTCATTTGATC	TCATGCCGTTTCATGTGATC	2
CGGAACTATCTTCAAGGTTG	CGGAACCATCTTCAACGTTG	2
TTTCATGTTATGCGGATAAC	TTTCATGTGATCCGGATAAC	2
AGTAGTCTAAATAAATTTAA	AGTAGTGCAAATAAATTTAA	2
TATCAGTTACAAACTCAAGA	CAGCAGTTACAAACTCAAGA	2
GTCAGAGTGGTGACAAGTGT	GTCAGAGTAGTGACAAGTGT	1
AAAGGACAGATAGTGTTGAC	AAAGGACAGATTGTGTCGAC	2
AAAGGACAGATTGTGCCGAC	AAAGGACAGATTGTGTCGAC	1
CATTCCTGTACATAACCGTC	CGTTCCTGTACATAACCTTC	2
TGGTTGTCTGATAAAAGGAC	TGGTTGTCTGGTAAAAGGAC	1
CGTTCCTGTACATAACCTAC	CGTTCCTGTACATAACCTTC	1
CGGAACCATCTTAAACGTTG	CGGAACCATCTTCAACGTTG	1
GTTTAATGTGATCCGGATAT	GTTTCATGTGATCCGGATAA	2
GCGTTCCTGTGCATAACCCT	GCGTTCCTGTACATAACCTT	2
ATTCGCTGGGATCTTTCGAA	TTTCGTTGGGATCTTTCGAA	2
CCGCAGTTACAAACTCAAGA	CAGCAGTTACAAACTCAAGA	1
GCGTTCCTGTACATTACCTT	GCGTTCCTGTACATAACCTT	1
TTAACTCGATATGATTAACA	TTAACTCGATACGATTAACA	1
CCATTTAATTCAACAAGAAT	CCATCTAATTCAACAAGAAT	1
AAAGGACATATTGTGTCGCC	AAAGGACAGATTGTGTCGAC	2
ATAATGGACTGCTAGTTGAC	ATAATGGTCTGCTAGTTGAA	2
CATCTAATTCAACAAGGATT	CATCTAATTCAACAAGAATT	1
TTGACTCGATACGATTAACA	TTAACTCGATACGATTAACA	1
TTGCAGCATTTTGTTGATAA	TTGGAGTATTTTGTTGATAA	2
CATGTGGTCAAGTTTTTCGT	CATGTGGTCACGCTTTTCGT	2
CCATGCCGTCTCATGTGATC	TCATGCCGTTTCATGTGATC	2
AAAGGACAGATGGTGTCGAC	AAAGGACAGATTGTGTCGAC	1
GCTTCATGTGATCCGGATAG	GTTTCATGTGATCCGGATAA	2
GACTTCAGCACGTGTGTTGT	GACTTCAGCACGCGTCTTGT	2
GTAGTGCCAAGTGTTGGCCT	GTAGTGACAAGTGTTGGCCA	2
TTAACTCGATAAGATTTACA	TTAACTCGATACGATTAACA	2
ACAAGTGTTGGCGACGGAAC	ACAAGTGTTGGCCACGGAAC	1
TGGTTGTCTGGTAAAAGGCC	TGGTTGTCTGGTAAAAGGAC	1
TAACTCGATACGATTAAGAA	TAACTCGATACGATTAACAA	1
TCAAGTGTTGGCCACGGTAC	ACAAGTGTTGGCCACGGAAC	2
TTTAGTTGGGATCTTTCGTA	TTTCGTTGGGATCTTTCGAA	2
TCATGCCGTTTCATGAGATC	TCATGCCGTTTCATGTGATC	1
GTTTCATGTGATCCGGAAAA	GTTTCATGTGATCCGGATAA	1
TTCGACATGTAATGGTTGTC	GTCGACAGGTAATGGTTGTC	2
CCTTCCTGGACATAACCTTC	CGTTCCTGTACATAACCTTC	2
TGGGTGTCTGGTAAAGGGAC	TGGTTGTCTGGTAAAAGGAC	2
AATAGTGCAAATAAATTTAA	AGTAGTGCAAATAAATTTAA	1
GGAAACGCATTGAACACCGT	GGAAAAGCATTGAACACCAT	2
TTTGAGTCTTTTGTTGATAA	TTGGAGTATTTTGTTGATAA	2
TCATGCCGTTTCATGTCATC	TCATGCCGTTTCATGTGATC	1
ATAATGATCTGCTAGTCGAA	ATAATGGTCTGCTAGTTGAA	2
AAAGGACAGGTTGTGTCGAC	AAAGGACAGATTGTGTCGAC	1
ACAAGTGTTGGCCCCGGAAC	ACAAGTGTTGGCCACGGAAC	1
GAGTAGTGCAAAGAAATTTA	CAGTAGTGCAAATAAATTTA	2
GCGTTCCTGTCCATAACCTT	GCGTTCCTGTACATAACCTT	1
AACTTCAGCACGCGACTTGT	GACTTCAGCACGCGTCTTGT	2
GTAGTGACAAGTGTAGGCCA	GTAGTGACAAGTGTTGGCCA	1
GGTTGTCTGTTAAAAGGACA	GGTTGTCTGGTAAAAGGACA	1
GGAAAAGCATTCAACACCAT	GGAAAAGCATTGAACACCAT	1
ATGTGGTCACTCTTTGCGTT	ATGTGGTCACGCTTTTCGTT	2
TTAACTCGATACGATAAACG	TTAACTCGATACGATTAACA	2
CCTTCCTATACATAACCTTC	CGTTCCTGTACATAACCTTC	2
GACTTCAGCACGCGGCTTGT	GACTTCAGCACGCGTCTTGT	1
GACTTCAGCACGCGTCGTGT	GACTTCAGCACGCGTCTTGT	1
ACAAGTGTTGGCCACGAAAC	ACAAGTGTTGGCCACGGAAC	1
GCGTTCCTGTTCATAACTTT	GCGTTCCTGTACATAACCTT	2
TTACATGTGATCCGGATAAC	TTTCATGTGATCCGGATAAC	1
CGGAACCATCATCAACGTTG	CGGAACCATCTTCAACGTTG	1
TTGGAGTAATTAGTTGATAA	TTGGAGTATTTTGTTGATAA	2
CGTTCCTGTCCATAATCTTC	CGTTCCTGTACATAACCTTC	2
GCGTTCCTGTACATAACCGT	GCGTTCCTGTACATAACCTT	1
GTCAGTGTAGTGACATGTGT	GTCAGAGTAGTGACAAGTGT	2
GTAGTGATACGTGTTGGCCA	GTAGTGACAAGTGTTGGCCA	2
CAGATTGTGGCGACAGGTGA	CAGATTGTGTCGACAGGTAA	2
AGGACAGGGCCATGGCCAAT	AGGACAGGGCCATCGCCAAT	1
ATGTGGTCACGCTATTCGTT	ATGTGGTCACGCTTTTCGTT	1
CAGCAGTTACAAACCGAAGA	CAGCAGTTACAAACTCAAGA	2
GTCGACAGGTAATCGTTGGC	GTCGACAGGTAATGGTTGTC	2
ATGTGGTCACGCTTTTCGCT	ATGTGGTCACGCTTTTCGTT	1
AGTTGTCTGGTAAAAGGACA	GGTTGTCTGGTAAAAGGACA	1
CAGCAGTTACAAACTCTAGA	CAGCAGTTACAAACTCAAGA	1
GTAGTGACAAGGGTTGGCCG	GTAGTGACAAGTGTTGGCCA	2
GGAATGACAAGTGTTGGCCA	GTAGTGACAAGTGTTGGCCA	2
TGAACTCGATACGATTAACT	TTAACTCGATACGATTAACA	2
GTTTCATGTGATCCAGATAA	GTTTCATGTGATCCGGATAA	1
CATGTGGACACGCTTTTGGT	CATGTGGTCACGCTTTTCGT	2
CATCACCTTCACCCTCCCCA	CATCACCTTCACCCTCTCCA	1
AGTAGTGGAAATAAATTCAA	AGTAGTGCAAATAAATTTAA	2
CATCAGCTTCACCCACTCCA	CATCACCTTCACCCTCTCCA	2
AAAGGACCGATTGTGTCGAG	AAAGGACAGATTGTGTCGAC	2
GTTTCATGTGATCCGGTTAA	GTTTCATGTGATCCGGATAA	1
GTCAGAGTAGTGTCAAGTGT	GTCAGAGTAGTGACAAGTGT	1
CATGTGGTCACCCTTTTCGT	CATGTGGTCACGCTTTTCGT	1
TTGTACATAACCTTCGGGGA	CTGTACATAACCTTCGGGCA	2
TAGATTGTGTCGACAGGTAA	CAGATTGTGTCGACAGGTAA	1
ATAATGGTCTGCTAGTTGAA	ATAATGGTCTGCTAGTTGAA	0
ATAATGGTCTGCTAGTTGAA	ATAATGGTCTGCTAGTTGAA	0
ATAATGGTCTGCTAGTTGAA	ATAATGGTCTGCTAGTTGAA	0
ATAATGGTCTGCTAGTTGAA	ATAATGGTCTGCTAGTTGAA	0
GTTTCTTGTGATCCGGCTAA	GTTTCATGTGATCCGGATAA	2
ACAAGAGTTGGCCACGGGAC	ACAAGTGTTGGCCACGGAAC	2
GTCAGAGTCGTTACAAGTGT	GTCAGAGTAGTGACAAGTGT	2
CGTTACTGTTCATAACCTTC	CGTTCCTGTACATAACCTTC	2
CTGTACATAGCCTTCGGGCA	CTGTACATAACCTTCGGGCA	1
GGGTGTCTGGTAAAAGGACG	GGTTGTCTGGTAAAAGGACA	2
CAAGCTCAAGAAGGACGATG	CAAACTCAAGAAGGACCATG	2
CATCTAATTCAACAAGAATC	CATCTAATTCAACAAGAATT	1
GTAGACAGGTAATGGTTGTG	GTCGACAGGTAATGGTTGTC	2
CAGCATTTACAAACTCAAGA	CAGCAGTTACAAACTCAAGA	1
CTGTACATAACCCTCGGGCA	CTGTACATAACCTTCGGGCA	1
CACATTGTGCCGACAGGTAA	CAGATTGTGTCGACAGGTAA	2
CCATCTATTTCAACAAGAAT	CCATCTAATTCAACAAGAAT	1
GTCGACAGGTCATGGTTGTC	GTCGACAGGTAATGGTTGTC	1
AAATGACAGATAGTGTCGAC	AAAGGACAGATTGTGTCGAC	2
CCGATTGTGTCGACAGGTAA	CAGATTGTGTCGACAGGTAA	1
TGGTTGTCTGGTATAAGGAA	TGGTTGTCTGGTAAAAGGAC	2
TTGGAGTATGTTGATGATAA	TTGGAGTATTTTGTTGATAA	2
CGTTCCTGTTCATAACCTTC	CGTTCCTGTACATAACCTTC	1
GTTCCATGTGATCCTGATAA	GTTTCATGTGATCCGGATAA	2
ATGGGGTCACGCTTTTCGTA	ATGTGGTCACGCTTTTCGTT	2
AAAGGACAGATTGTGTCTAC	AAAGGACAGATTGTGTCGAC	1
CAGATTGTGTCGTCAGGTAA	CAGATTGTGTCGACAGGTAA	1
CAGATTGTGTCGACTGGTAA	CAGATTGTGTCGACAGGTAA	1
AAAGGATAGATTGTGTCGAC	AAAGGACAGATTGTGTCGAC	1
GTAGTGAACAGTGTTGGCCA	GTAGTGACAAGTGTTGGCCA	2
CCACCTAATTCAACAAGAAT	CCATCTAATTCAACAAGAAT	1
CATCTCCTTCACGCTCTCCA	CATCACCTTCACCCTCTCCA	2
CATCACCTTCACCCTCTTCG	CATCACCTTCACCCTCTCCA	2
TTTTATGTGATCTGGATAAC	TTTCATGTGATCCGGATAAC	2
GGTAATTGTTGTCTGGTAAA	GGTAATGGTTGTCTGGTAAA	1
ATAATGGTCAGCGAGTTGAA	ATAATGGTCTGCTAGTTGAA	2
ATAACGGTCTGCTAGTTAAA	ATAATGGTCTGCTAGTTGAA	2
CGGAACCATCGTCAACATTG	CGGAACCATCTTCAACGTTG	2
GGTTGTCTGGTAAGAGGACA	GGTTGTCTGGTAAAAGGACA	1
CAGCAGTGACAAACTCAAGA	CAGCAGTTACAAACTCAAGA	1
AGGACAGTGCCCTCGCCAAT	AGGACAGGGCCATCGCCAAT	2
GAAGTGACAAGTGTTGGCCA	GTAGTGACAAGTGTTGGCCA	1
GATGTGGTTACGCTTTTCGT	CATGTGGTCACGCTTTTCGT	2
GTCGACAGGAACTGGTTGTC	GTCGACAGGTAATGGTTGTC	2
TTTTCATGTGATCCGGATTA	GTTTCATGTGATCCGGATAA	2
CATGTTGTCACGCTTTTGGT	CATGTGGTCACGCTTTTCGT	2
CGTTCCGGTACATAACCTTC	CGTTCCTGTACATAACCTTC	1
GTGATAGTAGTGACAAGTGT	GTCAGAGTAGTGACAAGTGT	2
TTTCGTTGGGATGTTACGAA	TTTCGTTGGGATCTTTCGAA	2
TCAAGCCGTTTCATGTAATC	TCATGCCGTTTCATGTGATC	2
TTGCGTTGGGATCTTTCGAA	TTTCGTTGGGATCTTTCGAA	1
CTGCAGTTCCAAACTCAAGA	CAGCAGTTACAAACTCAAGA	2
TAACTAGATACGATTAACGA	TAACTCGATACGATTAACAA	2
TAACTCGATACGATTACCAA	TAACTCGATACGATTAACAA	1
CGGAACCATCTTCACCGTTG	CGGAACCATCTTCAACGTTG	1
ACTAGTCCAAATAAATTTAA	AGTAGTGCAAATAAATTTAA	2
TTTCATGTGATCCGGATCAC	TTTCATGTGATCCGGATAAC	1
CATCAACTTCACCCTCTCCA	CATCACCTTCACCCTCTCCA	1
TTTCGTTAGGATCCTTCGAA	TTTCGTTGGGATCTTTCGAA	2
TTTCATGTGATCCGGCTAAC	TTTCATGTGATCCGGATAAC	1
GTCTCATGTGATCCGGATAA	GTTTCATGTGATCCGGATAA	1
GGTAATGGTTGTCTGGTTAT	GGTAATGGTTGTCTGGTAAA	2
CATCTAATTCATGAAGAATT	CATCTAATTCAACAAGAATT	2
TTGGAGAATTTTGTTGTTAA	TTGGAGTATTTTGTTGATAA	2
ACTAGTGTTGGTCACGGAAC	ACAAGTGTTGGCCACGGAAC	2
AGGACAGGTCCATCGCCAAT	AGGACAGGGCCATCGCCAAT	1
AATGGACAGATTGTGTCGAC	AAAGGACAGATTGTGTCGAC	1
CAAGCTCAAGAAGGAGCATG	CAAACTCAAGAAGGACCATG	2
GTTTCATGTGATTCGGATAA	GTTTCATGTGATCCGGATAA	1
GCGTTGATGTACATAACCTT	GCGTTCCTGTACATAACCTT	2
AGCAGTTCAAATAAATTTAA	AGTAGTGCAAATAAATTTAA	2
ACCAGTGTTGGCCACGGATC	ACAAGTGTTGGCCACGGAAC	2
GTCAGAGTAGTGACAGGTTT	GTCAGAGTAGTGACAAGTGT	2
CGAAACAATCTTCAACGTTG	CGGAACCATCTTCAACGTTG	2
ATAACTGTCTGCTAGTTGAA	ATAATGGTCTGCTAGTTGAA	2
CGTTCCTGTACATACCCGTC	CGTTCCTGTACATAACCTTC	2
ATAGGACAGATTGAGTCGAC	AAAGGACAGATTGTGTCGAC	2
GAAGTGACCAGTGTTGGCCA	GTAGTGACAAGTGTTGGCCA	2
CAGCAGTTACAAACTTAAGA	CAGCAGTTACAAACTCAAGA	1
TTTCGTCGGAATCTTTCGAA	TTTCGTTGGGATCTTTCGAA	2
CCATCTACATCAACAAGAAT	CCATCTAATTCAACAAGAAT	2
TTGGAGTATATTGTCGATAA	TTGGAGTATTTTGTTGATAA	2
CAGATTGTGTCGATAGGTAA	CAGATTGTGTCGACAGGTAA	1
CCTGTGGTCACGCTTTTCGA	CATGTGGTCACGCTTTTCGT	2
AGTAGTGCAAATAATTTTAA	AGTAGTGCAAATAAATTTAA	1
CGGAACCATATTTAACGTTG	CGGAACCATCTTCAACGTTG	2
TTTCATGTGATCCGGGTAAC	TTTCATGTGATCCGGATAAC	1
ATAATGGACTGCTAGTTGAA	ATAATGGTCTGCTAGTTGAA	1
ACGTTCCTGTACATAACCGT	GCGTTCCTGTACATAACCTT	2
CTGTAGTGCAAATAAATATA	CAGTAGTGCAAATAAATTTA	2
TTCCGTTGGGATCTTTCGAA	TTTCGTTGGGATCTTTCGAA	1
CGGAACCATCTTCAGCGTTG	CGGAACCATCTTCAACGTTG	1
CATGTGGTCACGCTTTTGGG	CATGTGGTCACGCTTTTCGT	2
GTCAAAATAGTGACAAGTGT	GTCAGAGTAGTGACAAGTGT	2
CATCTAATTCATCAAGAATT	CATCTAATTCAACAAGAATT	1
CATGAGGTCATGCTTTTCGT	CATGTGGTCACGCTTTTCGT	2
GACATCAGCACGCGTCTTGT	GACTTCAGCACGCGTCTTGT	1
TTTCGTTCAGATCTTTCGAA	TTTCGTTGGGATCTTTCGAA	2
ACAAGTGTTGGCCACGGCAC	ACAAGTGTTGGCCACGGAAC	1
GAATTCAGCACGCGTGTTGT	GACTTCAGCACGCGTCTTGT	2
CGAAACCATCTTCAACGTTG	CGGAACCATCTTCAACGTTG	1
AAAACGGTCTGCTAGTTGAA	ATAATGGTCTGCTAGTTGAA	2
CAAACTCAAGAAGCACCTTG	CAAACTCAAGAAGGACCATG	2
GTTTCATGTGATCCGCATAA	GTTTCATGTGATCCGGATAA	1
GTCGACAGGTAATGGTGGTC	GTCGACAGGTAATGGTTGTC	1
CAATCTAATTCAACAAGAAT	CCATCTAATTCAACAAGAAT	1
CAGTAGTGCAAATAAACTAA	CAGTAGTGCAAATAAATTTA	2
TTTCGTTGGGATCTTTCTAA	TTTCGTTGGGATCTTTCGAA	1
GGTCGTCTGGTAAAAGGACA	GGTTGTCTGGTAAAAGGACA	1
GTCTACAGGTGATGGTTGTC	GTCGACAGGTAATGGTTGTC	2
AGGTGGTCTGGTAAAAGGAC	TGGTTGTCTGGTAAAAGGAC	2
AGGACAGGCCCATCGTCAAT	AGGACAGGGCCATCGCCAAT	2
CAAACTCAAGCAGGACCATG	CAAACTCAAGAAGGACCATG	1
GTGGAGTATTTTGTTGATAA	TTGGAGTATTTTGTTGATAA	1
GTGAGAGTAGTAACAAGTGT	GTCAGAGTAGTGACAAGTGT	2
GTCGACATTTAATGGTTGTC	GTCGACAGGTAATGGTTGTC	2
TGGTTGTCTGGTAAAATGAC	TGGTTGTCTGGTAAAAGGAC	1
GTCGACAGGTAATGGATGTC	GTCGACAGGTAATGGTTGTC	1
CATGTGGTCACGCTTTTCGT	CATGTGGTCACGCTTTTCGT	0
CATGTGGTCACGCTTTTCGT	CATGTGGTCACGCTTTTCGT	0
CATGTGGTCACGCTTTTCGT	CATGTGGTCACGCTTTTCGT	0
CATGTGGTCACGCTTTTCGT	CATGTGGTCACGCTTTTCGT	0
GCGATCCTGTACATAACCTT	GCGTTCCTGTACATAACCTT	1
TTTCGGTGGGATCTTTCTAA	TTTCGTTGGGATCTTTCGAA	2
TTAACGCGATACGATTAAAA	TTAACTCGATACGATTAACA	2
CAAACTCAAGAAAGAACATG	CAAACTCAAGAAGGACCATG	2
AGTAGAGGAAATAAATTTAA	AGTAGTGCAAATAAATTTAA	2
TAACTCGACACGATTAACAA	TAACTCGATACGATTAACAA	1
CGTTCCTGTACATAACCTTA	CGTTCCTGTACATAACCTTC	1
GACTTTAGCACGGGTCTTGT	GACTTCAGCACGCGTCTTGT	2
CGAAAAGTATTGAACACCAT	GGAAAAGCATTGAACACCAT	2
CCATCTAATTCAACAAGAAT	CCATCTAATTCAACAAGAAT	0
CCATCTAATTCAACAAGAAT	CCATCTAATTCAACAAGAAT	0
CCATCTAATTCAACAAGAAT	CCATCTAATTCAACAAGAAT	0
CCATCTAATTCAACAAGAAT	CCATCTAATTCAACAAGAAT	0
TTCAGAGTAATGACAAGTGT	GTCAGAGTAGTGACAAGTGT	2
AGGACAGGGCCATTGCTAAT	AGGACAGGGCCATCGCCAAT	2
CATCTAATTCAGCAAGACTT	CATCTAATTCAACAAGAATT	2
GAACTCGATCCGATTAACAA	TAACTCGATACGATTAACAA	2
GAAAAAGCATTAAACACCAT	GGAAAAGCATTGAACACCAT	2
TTTAATGTGATCCGGATAAT	TTTCATGTGATCCGGATAAC	2
TTTCATGTAATCCGGATAAC	TTTCATGTGATCCGGATAAC	1
GGTAATGGTTGTCTGGTGAA	GGTAATGGTTGTCTGGTAAA	1
ACAAGTGTTGGCAACGGAAC	ACAAGTGTTGGCCACGGAAC	1
TTAATTCGATACGATTAACG	TTAACTCGATACGATTAACA	2
CGGAACCATCTTCAACGTTA	CGGAACCATCTTCAACGTTG	1
GGAAAAGCATTGAACACAAT	GGAAAAGCATTGAACACCAT	1
TTTCATGTGACACGGATAAC	TTTCATGTGATCCGGATAAC	2
CTCAGAATAGTGACAAGTGT	GTCAGAGTAGTGACAAGTGT	2
TCTGAGTATTTTGTTGATAA	TTGGAGTATTTTGTTGATAA	2
TTTCATGTGATACGGATAAC	TTTCATGTGATCCGGATAAC	1
CATCACCTTCTCACTCTCCA	CATCACCTTCACCCTCTCCA	2
ATAATGGTCTGCTAGCTGAA	ATAATGGTCTGCTAGTTGAA	1
CATCACCTTCACCCTGTCCA	CATCACCTTCACCCTCTCCA	1
CAGCATTTACAAACTGAAGA	CAGCAGTTACAAACTCAAGA	2
ATAATGGGCTGCTGGTTGAA	ATAATGGTCTGCTAGTTGAA	2
AGGACAGGGTCATCGCGAAT	AGGACAGGGCCATCGCCAAT	2
GTCGACAGGTAATAGTTGTC	GTCGACAGGTAATGGTTGTC	1
GTTTCTTGTGACCCGGATAA	GTTTCATGTGATCCGGATAA	2
ATAATGGTCTGCTAGTTGTA	ATAATGGTCTGCTAGTTGAA	1
CTGTCCATAATCTTCGGGCA	CTGTACATAACCTTCGGGCA	2
GTCGACAGGTAATGGTTGTC	GTCGACAGGTAATGGTTGTC	0
GTCGACAGGTAATGGTTGTC	GTCGACAGGTAATGGTTGTC	0
GTCGACAGGTAATGGTTGTC	GTCGACAGGTAATGGTTGTC	0
GTCGACAGGTAATGGTTGTC	GTCGACAGGTAATGGTTGTC	0
ATTTCATGTGATCCGGATAA	GTTTCATGTGATCCGGATAA	1
TTTCATGTGATCCTGATAAC	TTTCATGTGATCCGGATAAC	1
CCATCTAATTCGACAAGAAT	CCATCTAATTCAACAAGAAT	1
TATCTAATTCAACAAGAATT	CATCTAATTCAACAAGAATT	1
TTTGAGTATTTTGTTGATAA	TTGGAGTATTTTGTTGATAA	1
AGGACAGGGCAATCGCCAAT	AGGACAGGGCCATCGCCAAT	1
CTGTACATAACCTTCCGGCA	CTGTACATAACCTTCGGGCA	1
AGTATTGCAAATAAATTTAA	AGTAGTGCAAATAAATTTAA	1
TAACTCGATACGCTTAACAA	TAACTCGATACGATTAACAA	1
GTCAGAGTAGTGAGAAGTGT	GTCAGAGTAGTGACAAGTGT	1
AGGACAGTGCCATCGCCAGT	AGGACAGGGCCATCGCCAAT	2
TCATGCCCGTTCATGTGATC	TCATGCCGTTTCATGTGATC	2
CTGTACATAACCTGCGGGCA	CTGTACATAACCTTCGGGCA	1
CGTTCCTGTACATATCCTTC	CGTTCCTGTACATAACCTTC	1
CAAACTCAACAAGGACCATC	CAAACTCAAGAAGGACCATG	2
CCATCTAATCCAACAAGAAT	CCATCTAATTCAACAAGAAT	1
GGAAAAGCATTGAACACAGT	GGAAAAGCATTGAACACCAT	2
ACCAGTGTTGGCCAGGGAAC	ACAAGTGTTGGCCACGGAAC	2
TGGTTGTCTGGTAAATGGAC	TGGTTGTCTGGTAAAAGGAC	1
CACCAGCTACAAACTCAAGA	CAGCAGTTACAAACTCAAGA	2
CAGATCGTGTCGACAGGTAA	CAGATTGTGTCGACAGGTAA	1
CGTTCCTATACATAACCTTC	CGTTCCTGTACATAACCTTC	1
CTGTATATAACCTTCGAGCA	CTGTACATAACCTTCGGGCA	2
TAACTCGATACGATTAACCA	TAACTCGATACGATTAACAA	1
CATGTGGTCACGCTTGTCGT	CATGTGGTCACGCTTTTCGT	1
GCGTTCTTGTACATAACCTT	GCGTTCCTGTACATAACCTT	1
TTGGAGTATTTTGTTAGTAA	TTGGAGTATTTTGTTGATAA	2
CAACTCGCTACGATTAACAA	TAACTCGATACGATTAACAA	2
AGTAGTGCAAATAAATTTTA	AGTAGTGCAAATAAATTTAA	1
ACGACAGGGCCATCGCCAAT	AGGACAGGGCCATCGCCAAT	1
ACAATTGTTGGCCAGGGAAC	ACAAGTGTTGGCCACGGAAC	2
CATGTGGTCGCGCTTTTCGT	CATGTGGTCACGCTTTTCGT	1
TGTTTGTCTGGTAGAAGGAC	TGGTTGTCTGGTAAAAGGAC	2
GCCTTCAGCGCGCGTCTTGT	GACTTCAGCACGCGTCTTGT	2
CATCTAATACAACAAGAATT	CATCTAATTCAACAAGAATT	1
TTGGAGCATTTTGTTGATAA	TTGGAGTATTTTGTTGATAA	1
TAACTCGATACGATCAACAA	TAACTCGATACGATTAACAA	1
AGTAGTGCAAATAAATTTAG	AGTAGTGCAAATAAATTTAA	1
TTTCGTTGGGCTCTTTCGAA	TTTCGTTGGGATCTTTCGAA	1
CGGAACCATCTTCAACTTTG	CGGAACCATCTTCAACGTTG	1
CGGAATCATCGTCAACGTTG	CGGAACCATCTTCAACGTTG	2
AAAGGACAGATTGTGTCGAT	AAAGGACAGATTGTGTCGAC	1
AGGACAGGGCCATAGCCAAT	AGGACAGGGCCATCGCCAAT	1
GGAAAAGCATTAAACACCTT	GGAAAAGCATTGAACACCAT	2
CTGTTAATAACCTTCGGGCA	CTGTACATAACCTTCGGGCA	2
CTGTACCTAACCTTCGGGCA	CTGTACATAACCTTCGGGCA	1
TAACTCGACACGCTTAACAA	TAACTCGATACGATTAACAA	2
GACAGAGTAGTGAAAAGTGT	GTCAGAGTAGTGACAAGTGT	2
CAAACTCAAGAAGGTCCATG	CAAACTCAAGAAGGACCATG	1
TTGGTGTAATTTGTTGATAA	TTGGAGTATTTTGTTGATAA	2
TTAACTCGATACGATTAACC	TTAACTCGATACGATTAACA	1
CATGTGGTGACGCTTTTCAT	CATGTGGTCACGCTTTTCGT	2
CAGTAGTGCAAAAAAATTTA	CAGTAGTGCAAATAAATTTA	1
TTAACGCGAAACGATTAACA	TTAACTCGATACGATTAACA	2
TTTCTTGTGATCCGGATAAT	TTTCATGTGATCCGGATAAC	2
CTGTACATAACCGTCGGGTA	CTGTACATAACCTTCGGGCA	2
GGGAAACATCTTCAACGTTG	CGGAACCATCTTCAACGTTG	2
CCATCAAAATCAACAAGAAT	CCATCTAATTCAACAAGAAT	2
TTTCATGTGATCGGGATAAC	TTTCATGTGATCCGGATAAC	1
CATCTAATTGAACAAGCATT	CATCTAATTCAACAAGAATT	2
AAAGGTCAGATTGTGTCGAC	AAAGGACAGATTGTGTCGAC	1
TCATGCGGTTTCGTGTGATC	TCATGCCGTTTCATGTGATC	2
CGGAACCACCTTCAACGTTG	CGGAACCATCTTCAACGTTG	1
GCGTTCCCTTACATAACCTT	GCGTTCCTGTACATAACCTT	2
CATGTGGTCACGCTTTTCGC	CATGTGGTCACGCTTTTCGT	1
GTAGTGACAAGTGGTGGCCA	GTAGTGACAAGTGTTGGCCA	1
GAGATTGTTTCGACAGGTAA	CAGATTGTGTCGACAGGTAA	2
CAGCAGTTACAAGCTCAAAA	CAGCAGTTACAAACTCAAGA	2
ATTCATGTGATCCGGATACC	TTTCATGTGATCCGGATAAC	2
CATTACCTTGACCCTCTCCA	CATCACCTTCACCCTCTCCA	2
ATGTGGTCACGCTTTTAGTT	ATGTGGTCACGCTTTTCGTT	1
GGTAATGGTTGTCGGGTAAA	GGTAATGGTTGTCTGGTAAA	1
CATGTGGTCGCGCCTTTCGT	CATGTGGTCACGCTTTTCGT	2
GTTTCACGTGATCCAGATAA	GTTTCATGTGATCCGGATAA	2
TCATGTCGCTTCATGTGATC	TCATGCCGTTTCATGTGATC	2
CATGTGGTCACGCTTATCGC	CATGTGGTCACGCTTTTCGT	2
ACAACTGTTGGCCACGGAAC	ACAAGTGTTGGCCACGGAAC	1
TGGTTGTCTGGTAAAAAGAC	TGGTTGTCTGGTAAAAGGAC	1
CTGTACATACCCTTCGGGCA	CTGTACATAACCTTCGGGCA	1
CATGTGGTCACGCTCTTCGT	CATGTGGTCACGCTTTTCGT	1
AGTACAGGGCCATCGCCAAT	AGGACAGGGCCATCGCCAAT	1
GGTTGTCTGGTAAACGGACA	GGTTGTCTGGTAAAAGGACA	1
TGGTTGTCTGGTAAAAGTAC	TGGTTGTCTGGTAAAAGGAC	1
GGCAAAGCAGTGAACACCAT	GGAAAAGCATTGAACACCAT	2
CAGCAGTTAGAAACTCAAGA	CAGCAGTTACAAACTCAAGA	1
CATCACCTTCACCCTCTCAA	CATCACCTTCACCCTCTCCA	1
CATCCGATTCAACAAGAATT	CATCTAATTCAACAAGAATT	2
CAGCAGTTACAAACTCAAGT	CAGCAGTTACAAACTCAAGA	1
TTGCAGTAGTTTGTTGATAA	TTGGAGTATTTTGTTGATAA	2
CAGTAGTGCACATAAATTTG	CAGTAGTGCAAATAAATTTA	2
ATGTGGTCACGCTTTTCGAT	ATGTGGTCACGCTTTTCGTT	1
GTAGGCAGGTAATGGTTGTC	GTCGACAGGTAATGGTTGTC	2
ATGTGGTCACGCTTCTCGAT	ATGTGGTCACGCTTTTCGTT	2
CGTTCCTGTACGTAACCTTC	CGTTCCTGTACATAACCTTC	1
GGTTGTCTGGTAAAAGGAGA	GGTTGTCTGGTAAAAGGACA	1
ACAAGTGTTCGCCACGGAAC	ACAAGTGTTGGCCACGGAAC	1
TCATGCCGTTTCATGTGATC	TCATGCCGTTTCATGTGATC	0
TCATGCCGTTTCATGTGATC	TCATGCCGTTTCATGTGATC	0
TCATGCCGTTTCATGTGATC	TCATGCCGTTTCATGTGATC	0
TCATGCCGTTTCATGTGATC	TCATGCCGTTTCATGTGATC	0
CAGCAGTTATAAACTCAACA	CAGCAGTTACAAACTCAAGA	2
TTGTACATAACCTTCGGGCA	CTGTACATAACCTTCGGGCA	1
CTATACATAACCTTCGAGCA	CTGTACATAACCTTCGGGCA	2
ATGGGGTCACGCTTTTCGTT	ATGTGGTCACGCTTTTCGTT	1
GTAGACAGGTCATGGTTGTC	GTCGACAGGTAATGGTTGTC	2
AAAGGACAGATTGTCTCGAC	AAAGGACAGATTGTGTCGAC	1
AGTAGTGCTAATAAATTTAA	AGTAGTGCAAATAAATTTAA	1
CGGAAACATCTTCAACGTTG	CGGAACCATCTTCAACGTTG	1
CATCTAATTCAACAGGAATT	CATCTAATTCAACAAGAATT	1
GAGTTCCTGTACATCACCTT	GCGTTCCTGTACATAACCTT	2
CAAACTCAAGAAGGGCCTTG	CAAACTCAAGAAGGACCATG	2
CCTTCCTGTACATAACCTTC	CGTTCCTGTACATAACCTTC	1
ATATTGGTATGCTAGTTGAA	ATAATGGTCTGCTAGTTGAA	2
CCATCTAATTCAAAAAGAAT	CCATCTAATTCAACAAGAAT	1
CAGATTGTGTCATCAGGTAA	CAGATTGTGTCGACAGGTAA	2
GCGTTCGTGTACATAACCTT	GCGTTCCTGTACATAACCTT	1
TTTCGTTGGGATCTTTTGAA	TTTCGTTGGGATCTTTCGAA	1
CGGAACCATCTTCAACGTGG	CGGAACCATCTTCAACGTTG	1
GTAGTTACAAGTGATGGCCA	GTAGTGACAAGTGTTGGCCA	2
GTCGACAGGTAATGGTTCTG	GTCGACAGGTAATGGTTGTC	2
TAACTCGATACGTTTAACAA	TAACTCGATACGATTAACAA	1
CGTTCCTGTATATAACCTTC	CGTTCCTGTACATAACCTTC	1
TAACGCGATACGATTAACAA	TAACTCGATACGATTAACAA	1
GCGTTCCTGTACATAAGCTT	GCGTTCCTGTACATAACCTT	1
CAGCAGTTACAAAGTCAAGA	CAGCAGTTACAAACTCAAGA	1
TCATGCCGTTTCAAGTGATC	TCATGCCGTTTCATGTGATC	1
CGGAACCATCTACAACGTTG	CGGAACCATCTTCAACGTTG	1
AAAGGACAGACTATGTCGAC	AAAGGACAGATTGTGTCGAC	2
TAACTCGATACCATTGACAA	TAACTCGATACGATTAACAA	2
TTTCGATGGGATCTTTCGTA	TTTCGTTGGGATCTTTCGAA	2
TTTCGTTGGGATCTTTAGAA	TTTCGTTGGGATCTTTCGAA	1
AGGACAGCGCCATCGCCAAT	AGGACAGGGCCATCGCCAAT	1
GACTTCAGCACGCGTCTTGC	GACTTCAGCACGCGTCTTGT	1
CAGATTGTCTCGACAGGTAA	CAGATTGTGTCGACAGGTAA	1
CATCACCCTGACCCTCTCCA	CATCACCTTCACCCTCTCCA	2
TTACATATGATCCGGATAAC	TTTCATGTGATCCGGATAAC	2
TAGCTCGATACGATTATCAA	TAACTCGATACGATTAACAA	2
GGTAATGGCTGTCTGGTAAA	GGTAATGGTTGTCTGGTAAA	1
ATGTGCTCACGCTTTTGGTT	ATGTGGTCACGCTTTTCGTT	2
CAAGTGGTCACGGTTTTCGT	CATGTGGTCACGCTTTTCGT	2
ACAAGCATTGGCCACGGAAC	ACAAGTGTTGGCCACGGAAC	2
CGTTCTTGTACATAGCCTTC	CGTTCCTGTACATAACCTTC	2
GACTTCAGCACGCGTCATGT	GACTTCAGCACGCGTCTTGT	1
TGGTTTTCTTGTAAAAGGAC	TGGTTGTCTGGTAAAAGGAC	2
AAGGGACAGATTGTGTCGAC	AAAGGACAGATTGTGTCGAC	1
GAGTTCCGGTACATAACCTT	GCGTTCCTGTACATAACCTT	2
ATGTGGACACGCTTTTCGCT	ATGTGGTCACGCTTTTCGTT	2
CAATAGTGCAAATAAATTCA	CAGTAGTGCAAATAAATTTA	2
CAGCAGTTACAAACTTAAGG	CAGCAGTTACAAACTCAAGA	2
ACAAGTGTAGGCCACGGAAC	ACAAGTGTTGGCCACGGAAC	1
AGTAGTGCAACTAAAATTAA	AGTAGTGCAAATAAATTTAA	2
CATTTAACTCAACAAGAATT	CATCTAATTCAACAAGAATT	2
CCTGTGGTCAGGCTTTTCGT	CATGTGGTCACGCTTTTCGT	2
GGAAAAGCATTGAACACTAT	GGAAAAGCATTGAACACCAT	1
GTCGCCAGGTAATGGTTGTC	GTCGACAGGTAATGGTTGTC	1
AGGACGGGGCCATCCCCAAT	AGGACAGGGCCATCGCCAAT	2
GAGATTGGGTCGACAGGTAA	CAGATTGTGTCGACAGGTAA	2
CATATAATTCGACAAGAATT	CATCTAATTCAACAAGAATT	2
CGTTCCTTTACATAACCTTC	CGTTCCTGTACATAACCTTC	1
CATCTAATTCAATAAGAATT	CATCTAATTCAACAAGAATT	1
CACCACCTTAACCCTCTCCA	CATCACCTTCACCCTCTCCA	2
GGTTATGGTTCTCTGGTAAA	GGTAATGGTTGTCTGGTAAA	2
GGCAGAGTAGTGACAAGTAT	GTCAGAGTAGTGACAAGTGT	2
TGGTTGTCTGGTAAAAGGAT	TGGTTGTCTGGTAAAAGGAC	1
CATGTGGTCACGATTTTCGT	CATGTGGTCACGCTTTTCGT	1
GTCAGAGTAGTGACAAGTGC	GTCAGAGTAGTGACAAGTGT	1
GTACTGACAGGTGTTGGCCA	GTAGTGACAAGTGTTGGCCA	2
GGTTGACTGGTAAAAGGACA	GGTTGTCTGGTAAAAGGACA	1
TTGGAGTATTTTTATGATAA	TTGGAGTATTTTGTTGATAA	2
AGTAGTGCAAATAAAGTTAA	AGTAGTGCAAATAAATTTAA	1
AAAAGACAGATTGTGTCAAC	AAAGGACAGATTGTGTCGAC	2
CTCGACAGGTAATGGTTGTC	GTCGACAGGTAATGGTTGTC	1
TGGTTGTCCGGTAAAAGGAC	TGGTTGTCTGGTAAAAGGAC	1
TCATGCCGTTTCATGCGATC	TCATGCCGTTTCATGTGATC	1
TAACTCAATACGATTTACAA	TAACTCGATACGATTAACAA	2
CATCTCCTGCACCCTCTCCA	CATCACCTTCACCCTCTCCA	2
GTCAGAGTAGAGAAAAGTGT	GTCAGAGTAGTGACAAGTGT	2
CATGTGGTCACGGTTTTCGT	CATGTGGTCACGCTTTTCGT	1
TTAACACGATACGATTATCA	TTAACTCGATACGATTAACA	2
CATCACCTTTACCCTCTCCA	CATCACCTTCACCCTCTCCA	1
TTTCGTTGGGATCTCTCGAA	TTTCGTTGGGATCTTTCGAA	1
TATGTGGTCACGCTTTTCGT	CATGTGGTCACGCTTTTCGT	1
CAGGTGTTCACGCTTTTCGT	CATGTGGTCACGCTTTTCGT	2
TTAACTCTGTACGATTAACA	TTAACTCGATACGATTAACA	2
CAAACTCAAGAAGGATCATG	CAAACTCAAGAAGGACCATG	1
CATGTGGTCACGCTTTACGT	CATGTGGTCACGCTTTTCGT	1
TTTCATGTGATCCGCATAAC	TTTCATGTGATCCGGATAAC	1
TCATCCCGTTTCATGTGCTC	TCATGCCGTTTCATGTGATC	2
CAACTAAGTCAACAAGAATT	CATCTAATTCAACAAGAATT	2
CTAGTGACCAGTGTTGGCCA	GTAGTGACAAGTGTTGGCCA	2
CACACTCAAGAAGTACCATG	CAAACTCAAGAAGGACCATG	2
TTTCGTTAGGATCTGTCGAA	TTTCGTTGGGATCTTTCGAA	2
GGAACAGCATTGAACACCAT	GGAAAAGCATTGAACACCAT	1
ATCAGAGTCGTGACAAGTGT	GTCAGAGTAGTGACAAGTGT	2
CATCACCTTCGCCCTCTCCC	CATCACCTTCACCCTCTCCA	2
CATCACCTTCACCCTCGCCA	CATCACCTTCACCCTCTCCA	1
ACAAGAGTTGGCCACGGAAC	ACAAGTGTTGGCCACGGAAC	1
TTAACTCGATACGATTAAAA	TTAACTCGATACGATTAACA	1
ATGTGGTTACGCTTTTCGTT	ATGTGGTCACGCTTTTCGTT	1
GGTAATGGTGGTCTGGTAAA	GGTAATGGTTGTCTGGTAAA	1
TTGGAGTAATTTGTTGATAA	TTGGAGTATTTTGTTGATAA	1
CAGATTGTTTCGACAGGTAA	CAGATTGTGTCGACAGGTAA	1
AAAAGACAAATTGTGTCGAC	AAAGGACAGATTGTGTCGAC	2
TTGGAGGATTTGGTTGATAA	TTGGAGTATTTTGTTGATAA	2
GACTTCATCACGCGTCTTGT	GACTTCAGCACGCGTCTTGT	1
CAGCTAATTCAACAAGAATT	CATCTAATTCAACAAGAATT	1
TTATCTCGATACTATTAACA	TTAACTCGATACGATTAACA	2
GTTTCATGTTAGCCGGATAA	GTTTCATGTGATCCGGATAA	2
GCGTTCCTGTGCATAACCTA	GCGTTCCTGTACATAACCTT	2
TTAACTCGAGACGATTAACA	TTAACTCGATACGATTAACA	1
GGTAATGGTTGTCGGGTCAA	GGTAATGGTTGTCTGGTAAA	2
CATTACCTTCACCCTCTACA	CATCACCTTCACCCTCTCCA	2
GTTGACAGGTAATGGTTGTC	GTCGACAGGTAATGGTTGTC	1
CATCTAATTCAACAAGCATT	CATCTAATTCAACAAGAATT	1
CAGCACTTACAAACTCAAGA	CAGCAGTTACAAACTCAAGA	1
GGTAGTGCACATAAATTTAA	AGTAGTGCAAATAAATTTAA	2
CCTGTTGTCACGCTTTTCGT	CATGTGGTCACGCTTTTCGT	2
GGTAATGGTTGTCTGGGAAA	GGTAATGGTTGTCTGGTAAA	1
GTCGACAGCTAATGGTTGTC	GTCGACAGGTAATGGTTGTC	1
CCATCTAATACGACAAGAAT	CCATCTAATTCAACAAGAAT	2
CCTGTGGTCACGCTTTTCGT	CATGTGGTCACGCTTTTCGT	1
CAAACTCAAGAAGGCCCTTG	CAAACTCAAGAAGGACCATG	2
GCGTTCCTGTACATAACCTG	GCGTTCCTGTACATAACCTT	1
GTCGACAGGTAATGTTTGTC	GTCGACAGGTAATGGTTGTC	1
CCATCTAATTCAACAACAAT	CCATCTAATTCAACAAGAAT	1
ATACTGTTCTGCTAGTTGAA	ATAATGGTCTGCTAGTTGAA	2
GGTCATGGTTGACTGGTAAA	GGTAATGGTTGTCTGGTAAA	2
TTGGAGTATTTTGGTGATAA	TTGGAGTATTTTGTTGATAA	1
CAAACTCAAGAGGGACCATG	CAAACTCAAGAAGGACCATG	1
GGAAATGCATTGAACACCAA	GGAAAAGCATTGAACACCAT	2
TTTCCTGTGATCCGGATAAC	TTTCATGTGATCCGGATAAC	1
GTTTCCTGTGATCAGGATAA	GTTTCATGTGATCCGGATAA	2
TTTCATGTGCTCCGGATTAC	TTTCATGTGATCCGGATAAC	2
CAGATTGTGTCGGCAGGTAA	CAGATTGTGTCGACAGGTAA	1
ACAAGTGTTGGCCATGTAAC	ACAAGTGTTGGCCACGGAAC	2
CATGTGGTCATGCTTTTCGT	CATGTGGTCACGCTTTTCGT	1
ATATGGTCACGCTATTCGTT	ATGTGGTCACGCTTTTCGTT	2
AGTAGTGCAAATAAATATAA	AGTAGTGCAAATAAATTTAA	1
CATCTGATTCAACAAGAGTT	CATCTAATTCAACAAGAATT	2
GTCGACACGTAATGTTTGTC	GTCGACAGGTAATGGTTGTC	2
GTCGACAGGTAAAGGTTGAC	GTCGACAGGTAATGGTTGTC	2
GGATGTCTGGTAAAAGGACA	GGTTGTCTGGTAAAAGGACA	1
GGAAAAGCACTGAACACCAT	GGAAAAGCATTGAACACCAT	1
GTAGTGACAAGTGTTGGACA	GTAGTGACAAGTGTTGGCCA	1
AAACTCGATACGATTAGCAA	TAACTCGATACGATTAACAA	2
ATTTCATGTGATCCTGATAA	GTTTCATGTGATCCGGATAA	2
GGAAAAGCATTGAACACCAA	GGAAAAGCATTGAACACCAT	1
CGTGTGGTCACGCTTTGCGT	CATGTGGTCACGCTTTTCGT	2
CTGCAGTTACAAACTCATGA	CAGCAGTTACAAACTCAAGA	2
GTTTCATGTGATCAGGATAA	GTTTCATGTGATCCGGATAA	1
GGTTGTTTGGTAAGAGGACA	GGTTGTCTGGTAAAAGGACA	2
CAGTAGTGCAAATACATTTA	CAGTAGTGCAAATAAATTTA	1
ATGTGGTCACACTTTTCGTT	ATGTGGTCACGCTTTTCGTT	1
CATCACCTCCACTCTCTCCA	CATCACCTTCACCCTCTCCA	2
CTAACTCAAGAAGGACCCTG	CAAACTCAAGAAGGACCATG	2
GCAGTGACAAGTGTTGGCCA	GTAGTGACAAGTGTTGGCCA	1
AGAAAACCATTGAACACCAT	GGAAAAGCATTGAACACCAT	2
CGTTCCTGTACTTAACCTTC	CGTTCCTGTACATAACCTTC	1
TTAACTCGCTACGATTAAAA	TTAACTCGATACGATTAACA	2
CATTCCTGTACATAACCTTC	CGTTCCTGTACATAACCTTC	1
TATCATGTGATCCGGATAAC	TTTCATGTGATCCGGATAAC	1
GGAAAAGCATTGAATACCTT	GGAAAAGCATTGAACACCAT	2
TGGATGTCTGGTAACAGGAC	TGGTTGTCTGGTAAAAGGAC	2
GTGTCATGTGATCCGTATAA	GTTTCATGTGATCCGGATAA	2
GGTAATCGCTGTCTGGTAAA	GGTAATGGTTGTCTGGTAAA	2
ATGTGATCACGCTTTTCTTT	ATGTGGTCACGCTTTTCGTT	2
GGAAAAGCATTGAACACCAC	GGAAAAGCATTGAACACCAT	1
GACTTCAGCACACGTCTTGT	GACTTCAGCACGCGTCTTGT	1
GTAGTGACAAGTGTTAGCCA	GTAGTGACAAGTGTTGGCCA	1
AAATGACAGATTGTGTCGAC	AAAGGACAGATTGTGTCGAC	1
TCTCGTTGGGATCTTTCGAA	TTTCGTTGGGATCTTTCGAA	1
ACAAGTGTTGGCCACGGGAC	ACAAGTGTTGGCCACGGAAC	1
CAGCTAATTCAACAAGAGTT	CATCTAATTCAACAAGAATT	2
CGGAACCATCATCAACCTTG	CGGAACCATCTTCAACGTTG	2
ATTCATGTGATCCGGATAAC	TTTCATGTGATCCGGATAAC	1
GTAAAAGCCTTGAACACCAT	GGAAAAGCATTGAACACCAT	2
ATGTGGTCATGGTTTTCGTT	ATGTGGTCACGCTTTTCGTT	2
TTAACTCAATACGATTAACA	TTAACTCGATACGATTAACA	1
CAGATTCTGTCGACAGGTAA	CAGATTGTGTCGACAGGTAA	1
CCATGGCGTTTCATGTGATC	TCATGCCGTTTCATGTGATC	2
TGGTTGTCTGGGATAAGGAC	TGGTTGTCTGGTAAAAGGAC	2
CGCAACCATCTTCAACGTTG	CGGAACCATCTTCAACGTTG	1
CATCACCTTCGCCCTCTCCA	CATCACCTTCACCCTCTCCA	1
GACTTCAGCATCCGTCTTGT	GACTTCAGCACGCGTCTTGT	2
CAGCAGTTACAACCTCAAGA	CAGCAGTTACAAACTCAAGA	1
ACATGTGTTGGCCGCGGAAC	ACAAGTGTTGGCCACGGAAC	2
GACTTCAGCAGGCGTCTTGT	GACTTCAGCACGCGTCTTGT	1
TTAACTCAATACGATTCACA	TTAACTCGATACGATTAACA	2
GGTAATGGTTGACTCGTAAA	GGTAATGGTTGTCTGGTAAA	2
GGTTGTCTGGTAAAAGGAGT	GGTTGTCTGGTAAAAGGACA	2
TTAACTCGATACGATTTACA	TTAACTCGATACGATTAACA	1
ATGTGGTCACGTTTCTCGTT	ATGTGGTCACGCTTTTCGTT	2
GGAATAGCATTGAACACCAT	GGAAAAGCATTGAACACCAT	1
CCAAGTGTTGGCCACGGAAC	ACAAGTGTTGGCCACGGAAC	1
ATGTGGTCCCGCTTTTCGTT	ATGTGGTCACGCTTTTCGTT	1
AAGGGACAGATTGTGTCGGC	AAAGGACAGATTGTGTCGAC	2
TTACTTGTGATCCGGATAAC	TTTCATGTGATCCGGATAAC	2
AGGACAGGGCCATCCCCGAT	AGGACAGGGCCATCGCCAAT	2
CTGTAGTGCAAATAAATTTA	CAGTAGTGCAAATAAATTTA	1
TCATGGCGTTTCATGTGATC	TCATGCCGTTTCATGTGATC	1
GTGTTCCTGTACATAACCTC	GCGTTCCTGTACATAACCTT	2
GACTTCAACACGCGTCTGGT	GACTTCAGCACGCGTCTTGT	2
CAGATTGTGTCAACAGGTCA	CAGATTGTGTCGACAGGTAA	2
TGGTTGTCTGGTTAAAGGAT	TGGTTGTCTGGTAAAAGGAC	2
GGTAATGGTTGTCTGGTACA	GGTAATGGTTGTCTGGTAAA	1
CGTTCCTGTGCATGACCTTC	CGTTCCTGTACATAACCTTC	2
CAGCAGTCACAAACTCAAAA	CAGCAGTTACAAACTCAAGA	2
CAGATTGTGTCGAAAGGTAA	CAGATTGTGTCGACAGGTAA	1
GGTTGTCTGGGAAAAGGACA	GGTTGTCTGGTAAAAGGACA	1
ATAATGGTCAGCTAGTTGAA	ATAATGGTCTGCTAGTTGAA	1
TATCTCGATACGATTAACAA	TAACTCGATACGATTAACAA	1
GGAAAAGCATCGAACACCAT	GGAAAAGCATTGAACACCAT	1
TCATGCCATTTGATGTGATC	TCATGCCGTTTCATGTGATC	2
GACTTCAGCACGCGTCTAGT	GACTTCAGCACGCGTCTTGT	1
ACAAATGTTGTCCACGGAAC	ACAAGTGTTGGCCACGGAAC	2
CAAACTCAAGAAGGACAATG	CAAACTCAAGAAGGACCATG	1
GTCAGGGTAGTGACAAGCGT	GTCAGAGTAGTGACAAGTGT	2
ACAATTGTTGGCCTCGGAAC	ACAAGTGTTGGCCACGGAAC	2
GTCAGAGTAGCGACTAGTGT	GTCAGAGTAGTGACAAGTGT	2
TTGGAGTATTTTGTTGTTAG	TTGGAGTATTTTGTTGATAA	2
TTGGAGGCTTTTGTTGATAA	TTGGAGTATTTTGTTGATAA	2
CAGAAGTGCAAATAAATTTA	CAGTAGTGCAAATAAATTTA	1
GGTAATGGTTGTGAGGTAAA	GGTAATGGTTGTCTGGTAAA	2
CATCACCTTCACCCTCTCTA	CATCACCTTCACCCTCTCCA	1
ATGTGGTCACGCTTTTCTAT	ATGTGGTCACGCTTTTCGTT	2
TTACCTCGATACGATTAACA	TTAACTCGATACGATTAACA	1
GGTTCATGTGATCCGGATAA	GTTTCATGTGATCCGGATAA	1
GACGACAGGTAATGATTGTC	GTCGACAGGTAATGGTTGTC	2
AGGACTGGGCCATCGCCGAT	AGGACAGGGCCATCGCCAAT	2
TTTCGTTGGGATCTTAAGAA	TTTCGTTGGGATCTTTCGAA	2
CATCTAATTCAAAAAGAATT	CATCTAATTCAACAAGAATT	1
GGGACAGCATTGAACACCAT	GGAAAAGCATTGAACACCAT	2
ATGTGGTCACGCTTTACGTT	ATGTGGTCACGCTTTTCGTT	1
AAAGGACAGTTTGTGTCGAC	AAAGGACAGATTGTGTCGAC	1
TAATTCGATACGATTAACAA	TAACTCGATACGATTAACAA	1
AGGAACCATCTTCAACGTTG	CGGAACCATCTTCAACGTTG	1
CAAACTCAAGAAGGACTATG	CAAACTCAAGAAGGACCATG	1
AGTAGTGTAAAGAAATTTAA	AGTAGTGCAAATAAATTTAA	2
GTAGTGACAAGTGTCGGCCA	GTAGTGACAAGTGTTGGCCA	1
AAAGGACAGATTGGGTAGAC	AAAGGACAGATTGTGTCGAC	2
GCGTTCCAGTACATAACCTT	GCGTTCCTGTACATAACCTT	1
CATCTAATTCAACTAGAATA	CATCTAATTCAACAAGAATT	2
TTGGAGTATTTTGTTGATAG	TTGGAGTATTTTGTTGATAA	1
GTTAGAGTAGCGACAAGTGT	GTCAGAGTAGTGACAAGTGT	2
CAAACTCAAGGAGGACCATG	CAAACTCAAGAAGGACCATG	1
GCGTTCCTATACATAAACTT	GCGTTCCTGTACATAACCTT	2
CGGAACCATCTACAAGGTTG	CGGAACCATCTTCAACGTTG	2
CTGTACATACCCTTCGGGTA	CTGTACATAACCTTCGGGCA	2
CAGCAGTTACAAACTCAGCA	CAGCAGTTACAAACTCAAGA	2
TTCGACAGGTAATGGTTGTC	GTCGACAGGTAATGGTTGTC	1
GTAAGAGTAGTGACAAGTGT	GTCAGAGTAGTGACAAGTGT	1
CCATCTAATTCAACAAGACT	CCATCTAATTCAACAAGAAT	1
ACAAGTGTTGGCCACGGAAG	ACAAGTGTTGGCCACGGAAC	1
TTTCGTTGCGATCTTTCAAA	TTTCGTTGGGATCTTTCGAA	2
GTCGACAAGTAATGCTTGTC	GTCGACAGGTAATGGTTGTC	2
CTGTACATAACCTTAGGGCA	CTGTACATAACCTTCGGGCA	1
CATGTGGTGACGCTTGTCGT	CATGTGGTCACGCTTTTCGT	2
GTCGACAGGTAATGGTTGTT	GTCGACAGGTAATGGTTGTC	1
CAAACTCAAGAAGGACCCTG	CAAACTCAAGAAGGACCATG	1
TTTTGTTGGGATCTATCGAA	TTTCGTTGGGATCTTTCGAA	2
TTCTGAGTAGTGACAAGTGT	GTCAGAGTAGTGACAAGTGT	2
GCGTTCCTGTACAGAACCTT	GCGTTCCTGTACATAACCTT	1
TTAGTGACAAGTGTTGGCCA	GTAGTGACAAGTGTTGGCCA	1
ATGTGGTCACGCTATTCGGT	ATGTGGTCACGCTTTTCGTT	2
ATAGTGAGAAGTGTTGGCCA	GTAGTGACAAGTGTTGGCCA	2
TAACTCGACACGATTAACGA	TAACTCGATACGATTAACAA	2
TTGGAGTATTTTGCTGCTAA	TTGGAGTATTTTGTTGATAA	2
ACAAGTGTTGGCCATGGAAC	ACAAGTGTTGGCCACGGAAC	1
AGAAGTGCCAATAAATTTAA	AGTAGTGCAAATAAATTTAA	2
CGTAATGGTTGTCTGGTTAA	GGTAATGGTTGTCTGGTAAA	2
CTGTACATAACCTTCGGTCA	CTGTACATAACCTTCGGGCA	1
CGGAACCATCTTCAACCTTG	CGGAACCATCTTCAACGTTG	1
GGTTGTCTTGTAAAAGGACA	GGTTGTCTGGTAAAAGGACA	1
CAGATTGTGTCGACAGGCAA	CAGATTGTGTCGACAGGTAA	1
GTCAGAGTAGTGACAAGTGT	GTCAGAGTAGTGACAAGTGT	0
GTCAGAGTAGTGACAAGTGT	GTCAGAGTAGTGACAAGTGT	0
GTCAGAGTAGTGACAAGTGT	GTCAGAGTAGTGACAAGTGT	0
GTCAGAGTAGTGACAAGTGT	GTCAGAGTAGTGACAAGTGT	0
CTCGAGTATTTTGTTGATAA	TTGGAGTATTTTGTTGATAA	2
TGTTCCTGTACATAACCATC	CGTTCCTGTACATAACCTTC	2
GTAGTGACTAGTGTTGGCCA	GTAGTGACAAGTGTTGGCCA	1
CTGTACATAACTGTCGGGCA	CTGTACATAACCTTCGGGCA	2
GACGTCAGCACGCGTCTTGT	GACTTCAGCACGCGTCTTGT	1
TGGACAGGGCCATCCCCAAT	AGGACAGGGCCATCGCCAAT	2
TTAAATCGAGACGATTAACA	TTAACTCGATACGATTAACA	2
CTGTATATAGCCTTCGGGCA	CTGTACATAACCTTCGGGCA	2
GTTTCCTGTGATCCGGATAC	GTTTCATGTGATCCGGATAA	2
CTGTACATAAGCTTCGGTCA	CTGTACATAACCTTCGGGCA	2
CAGTAGTGCAAATAAACTTA	CAGTAGTGCAAATAAATTTA	1
AGGACAGGGCCAACGCGAAT	AGGACAGGGCCATCGCCAAT	2
CATCACCGTCACCCTCTCCA	CATCACCTTCACCCTCTCCA	1
GGAAGAGCATTGAACACTAT	GGAAAAGCATTGAACACCAT	2
TCATGGGGTTTCATGTGATC	TCATGCCGTTTCATGTGATC	2
TCGTAGTCTGGTAAAAGGAC	TGGTTGTCTGGTAAAAGGAC	2
CAAACTCAAGAAGGACCACT	CAAACTCAAGAAGGACCATG	2
CCATGTAATTCAACACGAAT	CCATCTAATTCAACAAGAAT	2
CAGATTGTGTGGACTGGTAA	CAGATTGTGTCGACAGGTAA	2
GGAAAAGCAGTGAACACCAT	GGAAAAGCATTGAACACCAT	1
TAACTAGATACGATTAACAA	TAACTCGATACGATTAACAA	1
CAGATTGTGTGGACAGGAAA	CAGATTGTGTCGACAGGTAA	2
CCATCTAATTCCACAAGAAT	CCATCTAATTCAACAAGAAT	1
TGGGTGTCTGGTAAAAGAAC	TGGTTGTCTGGTAAAAGGAC	2
TTTCATGTGATCCGGATAAT	TTTCATGTGATCCGGATAAC	1
TGGTTGTCTGGTACAAGGAC	TGGTTGTCTGGTAAAAGGAC	1
ATGTGGTCACGCTTTTCCTT	ATGTGGTCACGCTTTTCGTT	1
CATGTGGTCACGCTTTTCCT	CATGTGGTCACGCTTTTCGT	1
CAGCAGTTACAAACTCATGA	CAGCAGTTACAAACTCAAGA	1
GTCAGAGTAGTGAAAAGTGT	GTCAGAGTAGTGACAAGTGT	1
CCGAACCATCTTCAACGTTG	CGGAACCATCTTCAACGTTG	1
CAGTAGTGCAAATAAGTTTA	CAGTAGTGCAAATAAATTTA	1
TTTCGTTGGGATCTTTCGAT	TTTCGTTGGGATCTTTCGAA	1
TAACTCGATACGATTAGCAA	TAACTCGATACGATTAACAA	1
TTACATGTGATCCGGATTAC	TTTCATGTGATCCGGATAAC	2
CAAACTCAAGAATGACCAGG	CAAACTCAAGAAGGACCATG	2
TCATGGCGTTTGATGTGATC	TCATGCCGTTTCATGTGATC	2
CATGTGGTCTCGCTTTTCGT	CATGTGGTCACGCTTTTCGT	1
CAGTAGTGCAAATAATTTTA	CAGTAGTGCAAATAAATTTA	1
CCATCTTATTCAACAAGAAT	CCATCTAATTCAACAAGAAT	1
TCATGCCGTTTCGTGTGATC	TCATGCCGTTTCATGTGATC	1
TAACTTGATACTATTAACAA	TAACTCGATACGATTAACAA	2
AAAGCACAGAATGTGTCGAC	AAAGGACAGATTGTGTCGAC	2
GGGAACCATCTTCAACGTTC	CGGAACCATCTTCAACGTTG	2
GTGAGAGTAGTGACAACTGT	GTCAGAGTAGTGACAAGTGT	2
TCATGCCGTGTCATGTGATC	TCATGCCGTTTCATGTGATC	1
GTAGTGACAAGTGCTGACCA	GTAGTGACAAGTGTTGGCCA	2
CGGAACCATCTTTAAGGTTG	CGGAACCATCTTCAACGTTG	2
CTGTACATAACCTTCGGGTA	CTGTACATAACCTTCGGGCA	1
GGCGACAGTTAATGGTTGTC	GTCGACAGGTAATGGTTGTC	2
GTCCGAGTAGTGACAAGTAT	GTCAGAGTAGTGACAAGTGT	2
TAAACTCGGTACGATTAACA	TTAACTCGATACGATTAACA	2
ACAAGTGTTGGTCACGGATC	ACAAGTGTTGGCCACGGAAC	2
CATCTAATTCAAAAGGAATT	CATCTAATTCAACAAGAATT	2
CCATCTAATTCGACAGGAAT	CCATCTAATTCAACAAGAAT	2
GTTGCTTGTGATCCGGATAA	GTTTCATGTGATCCGGATAA	2
TCAGGCCGTTTCATGTGATC	TCATGCCGTTTCATGTGATC	1
GCGTTCCTGTACATAACGTT	GCGTTCCTGTACATAACCTT	1
TTGGAGTATTTTGTTAACAA	TTGGAGTATTTTGTTGATAA	2
GGTAATGGTTGTCTGGAAAA	GGTAATGGTTGTCTGGTAAA	1
GTCGACAGGGAATGGTTGTC	GTCGACAGGTAATGGTTGTC	1
CTGTACATAACCTTCGGCCA	CTGTACATAACCTTCGGGCA	1
CGGAACCATGTTCAACGTTT	CGGAACCATCTTCAACGTTG	2
CGGAACCATCGTCAACGTTG	CGGAACCATCTTCAACGTTG	1
TCATACCGTTACATGTGATC	TCATGCCGTTTCATGTGATC	2
GGTAATCGTTGTCTGGTAAA	GGTAATGGTTGTCTGGTAAA	1
GAACTCGATACGATTAACAA	TAACTCGATACGATTAACAA	1
CAAACTCAAGAAGGACTAGG	CAAACTCAAGAAGGACCATG	2
CGTCCCTGTACATAACCTGC	CGTTCCTGTACATAACCTTC	2
GGTTATGGTTGTCTGGGAAA	GGTAATGGTTGTCTGGTAAA	2
CCATCTAATTCAACACGCAT	CCATCTAATTCAACAAGAAT	2
GTAGTGACAATTGTTGGCCA	GTAGTGACAAGTGTTGGCCA	1
TTTCATGTGATCGGGATATC	TTTCATGTGATCCGGATAAC	2
TTGGAGTATTTTTTTGATAA	TTGGAGTATTTTGTTGATAA	1
TGGCTGTATGGTAAAAGGAC	TGGTTGTCTGGTAAAAGGAC	2
GTAGTGACAACTGTTGGCCA	GTAGTGACAAGTGTTGGCCA	1
AGGACAGGGGCATCGCCAAT	AGGACAGGGCCATCGCCAAT	1
AGGACAGGGCCATCGCCGAT	AGGACAGGGCCATCGCCAAT	1
GTTTGTCTGGTAAAAGTACA	GGTTGTCTGGTAAAAGGACA	2
CATCTATTTCAACCAGAATT	CATCTAATTCAACAAGAATT	2
CATGTGGGCACGCTTTTCAT	CATGTGGTCACGCTTTTCGT	2
CAGATCGTGTCGACAAGTAA	CAGATTGTGTCGACAGGTAA	2
GTCAGAGTAATGACTAGTGT	GTCAGAGTAGTGACAAGTGT	2
ATGTGGTCACGCTTTTTGTT	ATGTGGTCACGCTTTTCGTT	1
TTGGAGTATTTTGTAGATAA	TTGGAGTATTTTGTTGATAA	1
GGAAAAGCATTGAACAGTAT	GGAAAAGCATTGAACACCAT	2
GACTTCAGCACGCGTCTTAT	GACTTCAGCACGCGTCTTGT	1
ATAATGGTCTGCTATTTGAA	ATAATGGTCTGCTAGTTGAA	1
GTTTTGACAAGTGTTGGCCA	GTAGTGACAAGTGTTGGCCA	2
GTCTACAGGTAATGGTTGTC	GTCGACAGGTAATGGTTGTC	1
GGTTGTCTGTTAAAAGTACA	GGTTGTCTGGTAAAAGGACA	2
CGGAACGATCTTAAACGTTG	CGGAACCATCTTCAACGTTG	2
CCTCTAATTCAACAAGAATT	CATCTAATTCAACAAGAATT	1
CAGATTGTGTCGACAGGAAA	CAGATTGTGTCGACAGGTAA	1
AATCTCATTCAACAAGAATT	CATCTAATTCAACAAGAATT	2
GACTTCAGCACCCGTCTTGT	GACTTCAGCACGCGTCTTGT	1
TTTCGTCGGGATCTTTCGAG	TTTCGTTGGGATCTTTCGAA	2
AGTAGTGCAAATAGATTTAA	AGTAGTGCAAATAAATTTAA	1
CATATGATCACGCTTTTCGT	CATGTGGTCACGCTTTTCGT	2
CATCTAATTCAACAAGACTT	CATCTAATTCAACAAGAATT	1
CATCACCTTCACCATCTCCA	CATCACCTTCACCCTCTCCA	1
GGAAGAGCATTCAACACCAT	GGAAAAGCATTGAACACCAT	2
CATCACCTTCACCCTCTGCA	CATCACCTTCACCCTCTCCA	1
GTTTCATGAGATCCGGATAA	GTTTCATGTGATCCGGATAA	1
CTGTACATGACCTTAGGGCA	CTGTACATAACCTTCGGGCA	2
AGTAGTGCAAATAAACTTAA	AGTAGTGCAAATAAATTTAA	1
GGTTGTCTGGTAGAAAGACA	GGTTGTCTGGTAAAAGGACA	2
TTTCATGTGAGTCGGATAAC	TTTCATGTGATCCGGATAAC	2
CGTTCCTGCACATAACCTTC	CGTTCCTGTACATAACCTTC	1
AAAGGACAGATTATGTCGAC	AAAGGACAGATTGTGTCGAC	1
CTGTACATAACCTACGGCCA	CTGTACATAACCTTCGGGCA	2
CAGATCGTGTCGATAGGTAA	CAGATTGTGTCGACAGGTAA	2
ACAAGTGTCGGGCACGGAAC	ACAAGTGTTGGCCACGGAAC	2
CATGTGGTCACGCTTTTCGA	CATGTGGTCACGCTTTTCGT	1
GTTTCATGTGATCCGGATAG	GTTTCATGTGATCCGGATAA	1
GTCGACGGGTAATGCTTGTC	GTCGACAGGTAATGGTTGTC	2
CCATCTAATTCGACAAGAGT	CCATCTAATTCAACAAGAAT	2
ATGTGGTCACGCTACTCGTT	ATGTGGTCACGCTTTTCGTT	2
ACGTTCCTCTACATAACCTT	GCGTTCCTGTACATAACCTT	2
TTGGAGTATTTTCTTGATAA	TTGGAGTATTTTGTTGATAA	1
GGTTATCTGGTAAAAGGTCA	GGTTGTCTGGTAAAAGGACA	2
CGTTCCTGTACATAACCTTC	CGTTCCTGTACATAACCTTC	0
CGTTCCTGTACATAACCTTC	CGTTCCTGTACATAACCTTC	0
CGTTCCTGTACATAACCTTC	CGTTCCTGTACATAACCTTC	0
CGTTCCTGTACATAACCTTC	CGTTCCTGTACATAACCTTC	0
GTCGACAGGTAATGGTTTTC	GTCGACAGGTAATGGTTGTC	1
CGGAACCATCTTTAACGTTG	CGGAACCATCTTCAACGTTG	1
GTCGACAGGTAATTGCTGTC	GTCGACAGGTAATGGTTGTC	2
CGTTCCTGTACATAACCATC	CGTTCCTGTACATAACCTTC	1
AGGACAGGGCCATCGCCAAA	AGGACAGGGCCATCGCCAAT	1
GGTTGTCTGGTAAAAGGACG	GGTTGTCTGGTAAAAGGACA	1
TGGTTGTCTGGTTAAAGGAC	TGGTTGTCTGGTAAAAGGAC	1
CAGTAGTGCAAATAAATTCA	CAGTAGTGCAAATAAATTTA	1
GTCGTGACAAGTGTTGGCCA	GTAGTGACAAGTGTTGGCCA	1
GCGTTCCTGTACATAACCTT	GCGTTCCTGTACATAACCTT	0
GCGTTCCTGTACATAACCTT	GCGTTCCTGTACATAACCTT	0
GCGTTCCTGTACATAACCTT	GCGTTCCTGTACATAACCTT	0
GCGTTCCTGTACATAACCTT	GCGTTCCTGTACATAACCTT	0
CAGCAGTTACATCCTCAAGA	CAGCAGTTACAAACTCAAGA	2
TCATGCCGTTACATGTGATC	TCATGCCGTTTCATGTGATC	1
AAGACAGAGCCATCGCCAAT	AGGACAGGGCCATCGCCAAT	2
TAACTCGATACGATTCACTA	TAACTCGATACGATTAACAA	2
ACAAGTGTTGGGCACGGAAC	ACAAGTGTTGGCCACGGAAC	1
TCTCATTGGGATCTTTCGAA	TTTCGTTGGGATCTTTCGAA	2
CGGTCCTGTACATAACCTTC	CGTTCCTGTACATAACCTTC	1
ACATGTGTTGGCCACGGAAC	ACAAGTGTTGGCCACGGAAC	1
CAGCACCTTCACCCTCTCCA	CATCACCTTCACCCTCTCCA	1
TTGGAGTATTTCGTTGATAA	TTGGAGTATTTTGTTGATAA	1
CAGGAGTTACAAACTCAGGA	CAGCAGTTACAAACTCAAGA	2
AGGACAGGGCTATCGCCAAT	AGGACAGGGCCATCGCCAAT	1
CAGATTGTGTCGACACGTCA	CAGATTGTGTCGACAGGTAA	2
ATAATGGTCTGCTATTTTAA	ATAATGGTCTGCTAGTTGAA	2
AGGACACGGCTATCGCCAAT	AGGACAGGGCCATCGCCAAT	2
TTGGAGAATTTTGTTGATAA	TTGGAGTATTTTGTTGATAA	1
GTAGTGACAAGTGTTTGCCA	GTAGTGACAAGTGTTGGCCA	1
CGGGCCCATCTTCAACGTTG	CGGAACCATCTTCAACGTTG	2
TTGGAGTATTGTGTTGATAA	TTGGAGTATTTTGTTGATAA	1
CAACAGTTACAAACTCAACA	CAGCAGTTACAAACTCAAGA	2
TGATGCCGTTTCATGTGATA	TCATGCCGTTTCATGTGATC	2
CAGCAGTTACAAACTCACGA	CAGCAGTTACAAACTCAAGA	1
ATAATGGTATGCTAGTTGAA	ATAATGGTCTGCTAGTTGAA	1
ACAAGTGTCGGACACGGAAC	ACAAGTGTTGGCCACGGAAC	2
GTAGTAACAAGTGTTGGGCA	GTAGTGACAAGTGTTGGCCA	2
GTGCCATGTGATCCGGATAA	GTTTCATGTGATCCGGATAA	2
GTCAGAGTAGTGACAAGTGA	GTCAGAGTAGTGACAAGTGT	1
TTTCATGTGGTCCGGATAAC	TTTCATGTGATCCGGATAAC	1
CATCTAATTCAACGAGACTT	CATCTAATTCAACAAGAATT	2
GGAAACGCATTGAACACCAT	GGAAAAGCATTGAACACCAT	1
AAAGGACAAATTGTGTCGAC	AAAGGACAGATTGTGTCGAC	1
TGTTTGACTGGTAAAAGGAC	TGGTTGTCTGGTAAAAGGAC	2
GTAGTGACAAGTGTTGGCCC	GTAGTGACAAGTGTTGGCCA	1
TCGTCCCTGTACATAACCTT	GCGTTCCTGTACATAACCTT	2
TTTCGTTGGGACCTTTCGAA	TTTCGTTGGGATCTTTCGAA	1
CGTTCCTGTGCATAACCTCC	CGTTCCTGTACATAACCTTC	2
CAGTACTGCAAATCAATTTA	CAGTAGTGCAAATAAATTTA	2
AGGCGTGCAAATAAATTTAA	AGTAGTGCAAATAAATTTAA	2
CAAACTCAAGAAGCACCATG	CAAACTCAAGAAGGACCATG	1
GGAAAAGCATAGAACACCTT	GGAAAAGCATTGAACACCAT	2
CGTAACCATCCTCAACGTTG	CGGAACCATCTTCAACGTTG	2
TTAACTTGATTCGATTAACA	TTAACTCGATACGATTAACA	2
GTCGTCAGGTAGTGGTTGTC	GTCGACAGGTAATGGTTGTC	2
ATAATGGTCTGCTAGTGGAA	ATAATGGTCTGCTAGTTGAA	1
GTCAGAGTAGGGAGAAGTGT	GTCAGAGTAGTGACAAGTGT	2
CAAACTCAAGGCGGACCATG	CAAACTCAAGAAGGACCATG	2
AGAACAGGGCCATCGCCAAT	AGGACAGGGCCATCGCCAAT	1
TAATGCCGTATCATGTGATC	TCATGCCGTTTCATGTGATC	2
CTGTACATAACCTCCGGGCA	CTGTACATAACCTTCGGGCA	1
CAGATTGTGTCGACAGATAA	CAGATTGTGTCGACAGGTAA	1
TTGGAGTATTTTGTTGAAAA	TTGGAGTATTTTGTTGATAA	1
CAGCCGTTACAAACACAAGA	CAGCAGTTACAAACTCAAGA	2
GCTTCATGTGATCCGGATAA	GTTTCATGTGATCCGGATAA	1
TTTCATGTGATGCGCATAAC	TTTCATGTGATCCGGATAAC	2
GACTTCAGCACGCGACTTTT	GACTTCAGCACGCGTCTTGT	2
AGGAAAGGGCCATCGCCAAC	AGGACAGGGCCATCGCCAAT	2
CAAACTCAAGAAGTACCTTG	CAAACTCAAGAAGGACCATG	2
GTTTTATGTGATCCGGATAA	GTTTCATGTGATCCGGATAA	1
GTTCGTTGGGATCTTTCGAA	TTTCGTTGGGATCTTTCGAA	1
TTAACTCGATACGTTTAACA	TTAACTCGATACGATTAACA	1
TTAACTCGGCACGATTAACA	TTAACTCGATACGATTAACA	2
ATGTGGTCACGCTATTCTTT	ATGTGGTCACGCTTTTCGTT	2
CAGCAGTTACAAACTGAAGA	CAGCAGTTACAAACTCAAGA	1
TTGGAGTATGTTGTTGATAA	TTGGAGTATTTTGTTGATAA	1
GACTTCGGCACGCGTCTTGT	GACTTCAGCACGCGTCTTGT	1
GCGTACCTGTACAAAACCTT	GCGTTCCTGTACATAACCTT	2
AGGTGGTCACGCTTTTCGTT	ATGTGGTCACGCTTTTCGTT	1
TGACTCGATACGATGAACAA	TAACTCGATACGATTAACAA	2
CATCCCCTTCACCCTCTCCA	CATCACCTTCACCCTCTCCA	1
TTAACTCGATACGAATAACA	TTAACTCGATACGATTAACA	1
CAGATTGTGTCGACAGGTTA	CAGATTGTGTCGACAGGTAA	1
TTTCATGTGATCCGGTGAAC	TTTCATGTGATCCGGATAAC	2
TAACTCGATACGAATAACAA	TAACTCGATACGATTAACAA	1
AGGACAAGGCCATCGCCTAT	AGGACAGGGCCATCGCCAAT	2
CCATCTAATTCATCAAGAAT	CCATCTAATTCAACAAGAAT	1
CCGCAGTTACAAACTGAAGA	CAGCAGTTACAAACTCAAGA	2
ATGGGGTCAGGCTTTTCGTT	ATGTGGTCACGCTTTTCGTT	2
CAAACTCAAGAAGAACCGTG	CAAACTCAAGAAGGACCATG	2
AGTAGTGCAGCTAAATTTAA	AGTAGTGCAAATAAATTTAA	2
CATGTGGTCACGCTTCTCGT	CATGTGGTCACGCTTTTCGT	1
GTCAGAGTAGTGGCGAGTGT	GTCAGAGTAGTGACAAGTGT	2
CAAGCTCAAGTAGGACCATG	CAAACTCAAGAAGGACCATG	2
GCGTTCCGGTACATAACCTT	GCGTTCCTGTACATAACCTT	1
GCAAGTGTGGGCCACGGAAC	ACAAGTGTTGGCCACGGAAC	2
GACTTCAGGACGCGTCTTGT	GACTTCAGCACGCGTCTTGT	1
CGGTTGTCTGGTTAAAGGAC	TGGTTGTCTGGTAAAAGGAC	2
GGAAAAGCTTTGAACACCAT	GGAAAAGCATTGAACACCAT	1
TACTTCAGTACGCGTCTTGT	GACTTCAGCACGCGTCTTGT	2
CTTTTATGTGATCCGGATAA	GTTTCATGTGATCCGGATAA	2
TAACTCGAAACGATTAACAA	TAACTCGATACGATTAACAA	1
GGTAATAGTTGTCCGGTAAA	GGTAATGGTTGTCTGGTAAA	2
CATGTGGTTACGCTTTTCGT	CATGTGGTCACGCTTTTCGT	1
CAGCAGATACAAACACAAGA	CAGCAGTTACAAACTCAAGA	2
TAACTCGATACGATTAAGAT	TAACTCGATACGATTAACAA	2
CAACAGTTACAAACTCAATA	CAGCAGTTACAAACTCAAGA	2
ATAATGGTCTGCTAGTTGAT	ATAATGGTCTGCTAGTTGAA	1
GATCTAATTCAACAAGAATT	CATCTAATTCAACAAGAATT	1
TTTCATGTGATGCGGATAAC	TTTCATGTGATCCGGATAAC	1
GGTTGTCTGGAAAAAGGACA	GGTTGTCTGGTAAAAGGACA	1
CATCTAATTCCACAAGAATT	CATCTAATTCAACAAGAATT	1
CGTTCATGTACATAACCTTT	CGTTCCTGTACATAACCTTC	2
AAATTACAGATTGTGTCGAC	AAAGGACAGATTGTGTCGAC	2
ATAAGGGTCAGCTAGTTGAA	ATAATGGTCTGCTAGTTGAA	2
GTCTGATGTGATCCGGATAA	GTTTCATGTGATCCGGATAA	2
CCGTTCCTGTACATTACCTT	GCGTTCCTGTACATAACCTT	2
GTTTCATGTGATCTGGATAA	GTTTCATGTGATCCGGATAA	1
TGGTTGTCTGGTAAAAGGGC	TGGTTGTCTGGTAAAAGGAC	1
CTTTCCTGTACATAACCTTA	CGTTCCTGTACATAACCTTC	2
CAGATTGTGTCGACAGGTCA	CAGATTGTGTCGACAGGTAA	1
ATAATGGTCTGCTAGTTCAA	ATAATGGTCTGCTAGTTGAA	1
GTCAGAGCAGTGACAAGTAT	GTCAGAGTAGTGACAAGTGT	2
GTTTCATGTGACCCGGATAA	GTTTCATGTGATCCGGATAA	1
GCGTGCCTGTACATAACCTT	GCGTTCCTGTACATAACCTT	1
CCAGCTAATTCAACAAGAAT	CCATCTAATTCAACAAGAAT	1
CATCACCTACACCCTCTCCC	CATCACCTTCACCCTCTCCA	2
AGTAGTGCCAATAAATTTAA	AGTAGTGCAAATAAATTTAA	1
TCATGCAGTTTCCTGTGATC	TCATGCCGTTTCATGTGATC	2
CAGTAGTGCAAATCATTTTA	CAGTAGTGCAAATAAATTTA	2
TGGTTGTCTGGTAAACGTAC	TGGTTGTCTGGTAAAAGGAC	2
TTTCATGTGATCCAGATAAC	TTTCATGTGATCCGGATAAC	1
GTCGACAGGTAATGGTATTC	GTCGACAGGTAATGGTTGTC	2
GGAAAAGAATAGAACACCAT	GGAAAAGCATTGAACACCAT	2
TGGTTGTCTGGTAAAAAAAC	TGGTTGTCTGGTAAAAGGAC	2
CATCTAATTCAACGAGAATT	CATCTAATTCAACAAGAATT	1
GTTTCACGTGATCCGGATAA	GTTTCATGTGATCCGGATAA	1
TTTCTGGTGATCCGGATAAC	TTTCATGTGATCCGGATAAC	2
GTCAGAGTAGTGACAAATGT	GTCAGAGTAGTGACAAGTGT	1
TTTCGGTGGGATCTTTCGAA	TTTCGTTGGGATCTTTCGAA	1
AAAGGACTGATTGTGTCTAC	AAAGGACAGATTGTGTCGAC	2
CTGCACATAACCTTCCGGCA	CTGTACATAACCTTCGGGCA	2
AGTAGTTCAAATAAATTTAA	AGTAGTGCAAATAAATTTAA	1
CGGAACCATTTTCAACGTTT	CGGAACCATCTTCAACGTTG	2
GGTTCGTGTACATAACCTTC	CGTTCCTGTACATAACCTTC	2
GTAAAAGCACTGAACACCAT	GGAAAAGCATTGAACACCAT	2
GTCAGAGTAGTAACAAGTGT	GTCAGAGTAGTGACAAGTGT	1
AGGACAGGACCATCGCCAAT	AGGACAGGGCCATCGCCAAT	1
TTTCGTTGGGATCTTTCGAG	TTTCGTTGGGATCTTTCGAA	1
GGAAAAGCTTTGAACCCCAT	GGAAAAGCATTGAACACCAT	2
CAGTAGTGGAAATAAATATA	CAGTAGTGCAAATAAATTTA	2
ATAATGGTTTGCTAGCTGAA	ATAATGGTCTGCTAGTTGAA	2
CGGAACCATCTTCAACGGTG	CGGAACCATCTTCAACGTTG	1
TTTCATGTGATCCGGATAAG	TTTCATGTGATCCGGATAAC	1
AGGACAGGGCCGTCGCCAAT	AGGACAGGGCCATCGCCAAT	1
CGTTCCTGTACATCACCTTC	CGTTCCTGTACATAACCTTC	1
GTTAGAGTAGTGACAAATGT	GTCAGAGTAGTGACAAGTGT	2
CTGGAGTATTTTATTGATAA	TTGGAGTATTTTGTTGATAA	2
GCCTTCAGCACGCGTCTTCT	GACTTCAGCACGCGTCTTGT	2
GACAGAGTAATGACAAGTGT	GTCAGAGTAGTGACAAGTGT	2
GACTTCAGCTCGCGTCTTGT	GACTTCAGCACGCGTCTTGT	1
CAGTAGTGCAACTAAATTGA	CAGTAGTGCAAATAAATTTA	2
AGTAGTGCAAAAAAATTTAA	AGTAGTGCAAATAAATTTAA	1
CATGTGGTCACGCTTATCGT	CATGTGGTCACGCTTTTCGT	1
GACAGAGTAGTGACAAGTGT	GTCAGAGTAGTGACAAGTGT	1
CAGCCGTTACAAACTCAAGA	CAGCAGTTACAAACTCAAGA	1
GCGTTCCTGTTCATAACCTT	GCGTTCCTGTACATAACCTT	1
AGGACAGGGCCATCCCCAAT	AGGACAGGGCCATCGCCAAT	1
TAACTCGATACGAGTAAAAA	TAACTCGATACGATTAACAA	2
GTGAGAGTAGTGACAAGTGT	GTCAGAGTAGTGACAAGTGT	1
GCGCTCCTGTACAAAACCTT	GCGTTCCTGTACATAACCTT	2
GTTTCATGTGATCCGGGTAA	GTTTCATGTGATCCGGATAA	1
CGGACCCGTCTTCAACGTTG	CGGAACCATCTTCAACGTTG	2
CGTTCCTGTAGTTAACCTTC	CGTTCCTGTACATAACCTTC	2
GATGTGCTCACGCTTTTCGT	CATGTGGTCACGCTTTTCGT	2
CATCTAATTCAACAAGAGTT	CATCTAATTCAACAAGAATT	1
TAACTCGATACGATTAACAT	TAACTCGATACGATTAACAA	1
CGTTAGTGTACATAACCTTC	CGTTCCTGTACATAACCTTC	2
ATGCGATCACGCTTTTCGTT	ATGTGGTCACGCTTTTCGTT	2
GTCCACAGGTAATTGTTGTC	GTCGACAGGTAATGGTTGTC	2
CGGAACCATCTACCACGTTG	CGGAACCATCTTCAACGTTG	2
TCATGCAGTTTCATTTGATC	TCATGCCGTTTCATGTGATC	2
CAGCAGTTACAAACTCAAGC	CAGCAGTTACAAACTCAAGA	1
TTTCACGTCATCCGGATAAC	TTTCATGTGATCCGGATAAC	2
TTGGAGTATTTTGTTGGTAA	TTGGAGTATTTTGTTGATAA	1
AGTAGTGTAAATAAATTTAA	AGTAGTGCAAATAAATTTAA	1
TGGTTGTCTTGTAAAAGGAC	TGGTTGTCTGGTAAAAGGAC	1
CATCTAATTCAACCAGAATT	CATCTAATTCAACAAGAATT	1
CAGGTTGCGTCGACAGGTAA	CAGATTGTGTCGACAGGTAA	2
CAGTACACAACCTTCGGGCA	CTGTACATAACCTTCGGGCA	2
CATGTGGTCACGCTTTTAAT	CATGTGGTCACGCTTTTCGT	2
TGGTTGTCTGGAAAAAGGAC	TGGTTGTCTGGTAAAAGGAC	1
CATCACCTTCACCCTCTCCA	CATCACCTTCACCCTCTCCA	0
CATCACCTTCACCCTCTCCA	CATCACCTTCACCCTCTCCA	0
CATCACCTTCACCCTCTCCA	CATCACCTTCACCCTCTCCA	0
CATCACCTTCACCCTCTCCA	CATCACCTTCACCCTCTCCA	0
AGTACTGCAAATAAAATTAA	AGTAGTGCAAATAAATTTAA	2
CATTTAATTCAACAAGAATT	CATCTAATTCAACAAGAATT	1
GCCAGAGTAGAGACAAGTGT	GTCAGAGTAGTGACAAGTGT	2
CAAACTCAAGAAGAACCATG	CAAACTCAAGAAGGACCATG	1
GACTTCAGCACGCCTCGTGT	GACTTCAGCACGCGTCTTGT	2
GGAAAAGCATTGAACACCTC	GGAAAAGCATTGAACACCAT	2
CAGCTAATTCAACAAGACTT	CATCTAATTCAACAAGAATT	2
GTTTCATGTGATCCCGATAA	GTTTCATGTGATCCGGATAA	1
TTCCGTTGGGATCTTTCGTA	TTTCGTTGGGATCTTTCGAA	2
GTAAAAGCATTGAACACCAT	GGAAAAGCATTGAACACCAT	1
TAACTCGATACGAGTCACAA	TAACTCGATACGATTAACAA	2
ACAAGTGTTGGCCACGGACC	ACAAGTGTTGGCCACGGAAC	1
TAACTCGATACGTTTAGCAA	TAACTCGATACGATTAACAA	2
TTTCGTTGGGATCTTACGAA	TTTCGTTGGGATCTTTCGAA	1
CAGATTGTCTAGACAGGTAA	CAGATTGTGTCGACAGGTAA	2
AGTAGTGTAAATAAATTTAT	AGTAGTGCAAATAAATTTAA	2
AGGACAGGGCCATCGCCATT	AGGACAGGGCCATCGCCAAT	1
CGTTCCTGTACATAACTTTC	CGTTCCTGTACATAACCTTC	1
GTCATAGTAGTGATAAGTGT	GTCAGAGTAGTGACAAGTGT	2
AAAGGACAGATTGGGTGGAC	AAAGGACAGATTGTGTCGAC	2
TTAGAGTATTTTGTTGAAAA	TTGGAGTATTTTGTTGATAA	2
TTTCAAGTGATCCGGCTAAC	TTTCATGTGATCCGGATAAC	2
CATCACCTCCACCCTCTCCA	CATCACCTTCACCCTCTCCA	1
AGTAGTGCAAATATATTCAA	AGTAGTGCAAATAAATTTAA	2
TGGGTGTCTGGTCAAAGGAC	TGGTTGTCTGGTAAAAGGAC	2
GTTTCATGTGATCTTGATAA	GTTTCATGTGATCCGGATAA	2
CTGTACATAACCTTTGGGCA	CTGTACATAACCTTCGGGCA	1
CATCACCTTCACCCTCACCA	CATCACCTTCACCCTCTCCA	1
GCGTTCCTGTACATGACCTT	GCGTTCCTGTACATAACCTT	1
CGTCACCTTCCCCCTCTCCA	CATCACCTTCACCCTCTCCA	2
TGACTCGCTACGATTAACAA	TAACTCGATACGATTAACAA	2
ATGTGGTCGCGCTTTTCGTT	ATGTGGTCACGCTTTTCGTT	1
CATGCGGTCGCGCTTTTCGT	CATGTGGTCACGCTTTTCGT	2
CTGTACATACCCTTGGGGCA	CTGTACATAACCTTCGGGCA	2
GGTAATGGTTGTCAGGTAAA	GGTAATGGTTGTCTGGTAAA	1
TGGGTGTCTGGTAAAAGGAC	TGGTTGTCTGGTAAAAGGAC	1
AGAGGACAGATTGTGTCGAC	AAAGGACAGATTGTGTCGAC	1
ACAAGTGTGGGCCACGGAAC	ACAAGTGTTGGCCACGGAAC	1
GTAGTGACAAGTGTTGGGCA	GTAGTGACAAGTGTTGGCCA	1
ATGTTGTCACGATTTTCGTT	ATGTGGTCACGCTTTTCGTT	2
CGGTCTAATTCAACAAGAAT	CCATCTAATTCAACAAGAAT	2
TTTCGTTGGGATCCTTCGAA	TTTCGTTGGGATCTTTCGAA	1
CAGTAGTGCAAATAATTTTT	CAGTAGTGCAAATAAATTTA	2
GTCGGAGTAGTGACAAGTGA	GTCAGAGTAGTGACAAGTGT	2
TGGTTGTCTGCTAAAAGGAC	TGGTTGTCTGGTAAAAGGAC	1
CGGCACCATCTTCAACGCTG	CGGAACCATCTTCAACGTTG	2
CAGTAGTGCAAATACATATA	CAGTAGTGCAAATAAATTTA	2
GCGTTCCTGTAGATAACCTT	GCGTTCCTGTACATAACCTT	1
ATAATAGTCTGCTAGTTCAA	ATAATGGTCTGCTAGTTGAA	2
CAGCAGTTACAAACTCCAGA	CAGCAGTTACAAACTCAAGA	1
ATGTGGTCACGCTTTGCGTT	ATGTGGTCACGCTTTTCGTT	1
GCCTTCAGCACGCGTCGTGT	GACTTCAGCACGCGTCTTGT	2
TCATGCCGTTTTATGTGATC	TCATGCCGTTTCATGTGATC	1
AGGACAGGGCCATCGCCAAG	AGGACAGGGCCATCGCCAAT	1
TTAACTCGTTACGATTAACA	TTAACTCGATACGATTAACA	1
GCGTTCCTGGACATACCCTT	GCGTTCCTGTACATAACCTT	2
GGTTGTCTGGTAATAGGACA	GGTTGTCTGGTAAAAGGACA	1
TTGGAGTAGTTTGTTGATAA	TTGGAGTATTTTGTTGATAA	1
CGTGTGGTCACGCTTTTCGT	CATGTGGTCACGCTTTTCGT	1
TTTCGTTGGGATCTTTCGTA	TTTCGTTGGGATCTTTCGAA	1
GTCAGAGTTGTGACAAGTGT	GTCAGAGTAGTGACAAGTGT	1
ATAATGGTCTGATAGTTGCA	ATAATGGTCTGCTAGTTGAA	2
ACAAGTGTGGGCCAGGGAAC	ACAAGTGTTGGCCACGGAAC	2
CAGACTGTGTCGATAGGTAA	CAGATTGTGTCGACAGGTAA	2
ATAATGGTCTGTTAGTTCAA	ATAATGGTCTGCTAGTTGAA	2
ACAAATGTTGGCCACGAAAC	ACAAGTGTTGGCCACGGAAC	2
TTGTAGTATTCTGTTGATAA	TTGGAGTATTTTGTTGATAA	2
AAAGGACAGATTGGGTCGAC	AAAGGACAGATTGTGTCGAC	1
ATGTGGTCACGCTTTTCATT	ATGTGGTCACGCTTTTCGTT	1
TAATGCCGTTTCCTGTGATC	TCATGCCGTTTCATGTGATC	2
GTCAGAGTAATGACAAGTGT	GTCAGAGTAGTGACAAGTGT	1
TTTGGCTGGGATCTTTCGAA	TTTCGTTGGGATCTTTCGAA	2
GAATTCATCACGCGTCTTGT	GACTTCAGCACGCGTCTTGT	2
TTACGTTGGGACCTTTCGAA	TTTCGTTGGGATCTTTCGAA	2
CATCACCACCACCCTCTCCA	CATCACCTTCACCCTCTCCA	2
TAAACTCGATACGATTAACA	TTAACTCGATACGATTAACA	1
TAACTCGATACGATTAACAC	TAACTCGATACGATTAACAA	1
GAGTAGTGCAAATAAATTTA	CAGTAGTGCAAATAAATTTA	1
CTGTACATAACATTCTGGCA	CTGTACATAACCTTCGGGCA	2
TTATGCCGTTTCATGTGATC	TCATGCCGTTTCATGTGATC	1
GGTAATGGTTGTCTGGTTAA	GGTAATGGTTGTCTGGTAAA	1
GACTTCAGCATGCGTCTTGT	GACTTCAGCACGCGTCTTGT	1
GCGTTCCTGCACATAACCTT	GCGTTCCTGTACATAACCTT	1
TGGGTGTATGGTAAAAGGAC	TGGTTGTCTGGTAAAAGGAC	2
GTCAGAGTAGTGACAACTGT	GTCAGAGTAGTGACAAGTGT	1
AACGGACAGGTTGTGTCGAC	AAAGGACAGATTGTGTCGAC	2
CATCTAATTCAACAAGAACT	CATCTAATTCAACAAGAATT	1
TTTCATGTGATCTGGATAAC	TTTCATGTGATCCGGATAAC	1
ACAATGGTCTGCTAGTTGAA	ATAATGGTCTGCTAGTTGAA	1
TTGGAGAATTTCGTTGATAA	TTGGAGTATTTTGTTGATAA	2
GGAAAAGCACTGAAGACCAT	GGAAAAGCATTGAACACCAT	2
TTTCGCTGGGATCTTTTGAA	TTTCGTTGGGATCTTTCGAA	2
GTCGACAGGTAATGGGTGTC	GTCGACAGGTAATGGTTGTC	1
CTTTACATAACCTTCAGGCA	CTGTACATAACCTTCGGGCA	2
GGTAGAGTAGTGACAAGTGT	GTCAGAGTAGTGACAAGTGT	2
TCATGCCGTTTCTTGTGATC	TCATGCCGTTTCATGTGATC	1
TTAACTCTATACGATTAACA	TTAACTCGATACGATTAACA	1
CATCCAAATCAACAAGAATT	CATCTAATTCAACAAGAATT	2
GTCGACAGGTAACGGTTGTC	GTCGACAGGTAATGGTTGTC	1
AGTCGTGCAAATACATTTAA	AGTAGTGCAAATAAATTTAA	2
ATAATGGTCTACTATTTGAA	ATAATGGTCTGCTAGTTGAA	2
GTCAGAGTAATGACCAGTGT	GTCAGAGTAGTGACAAGTGT	2
CACCTAATTCAAGAAGAATT	CATCTAATTCAACAAGAATT	2
TGATGACGTTTCATGTGATC	TCATGCCGTTTCATGTGATC	2
TTTCGTTGAGATCTTTCGAA	TTTCGTTGGGATCTTTCGAA	1
ACAAACGTTGGCCACGGAAC	ACAAGTGTTGGCCACGGAAC	2
TGATTGTCTGGTAAAAGGAC	TGGTTGTCTGGTAAAAGGAC	1
TTTAAGGTGATCCGGATAAC	TTTCATGTGATCCGGATAAC	2
TTAACTCGATACGATTAAGT	TTAACTCGATACGATTAACA	2
GTTTCATGTGATCCAGATGA	GTTTCATGTGATCCGGATAA	2
CATCTAATTCGACAAGAATT	CATCTAATTCAACAAGAATT	1
CCATCTAACTCAACAACAAT	CCATCTAATTCAACAAGAAT	2
AGTAGTGCAAAAAAATTGAA	AGTAGTGCAAATAAATTTAA	2
CGGAACCATCTTCAAAGTTG	CGGAACCATCTTCAACGTTG	1
GTAGTGAAAAGTCTTGGCCA	GTAGTGACAAGTGTTGGCCA	2
ATAATGGTCTACTAGTTGAA	ATAATGGTCTGCTAGTTGAA	1
GGTAATGGTTGTCTTGTAAA	GGTAATGGTTGTCTGGTAAA	1
TGGTTGACTGGTAAAAGGAC	TGGTTGTCTGGTAAAAGGAC	1
CAGATTGTGTCGGCAGATAA	CAGATTGTGTCGACAGGTAA	2
GCGTTCCTGTACATAACCTC	GCGTTCCTGTACATAACCTT	1
TTAACCCGATACGATTAACA	TTAACTCGATACGATTAACA	1
CGGAACCATCTTCTACGTTG	CGGAACCATCTTCAACGTTG	1
TTTCGTCGGGATCTTTCGAC	TTTCGTTGGGATCTTTCGAA	2
TAAGGACAGATTGTGTCGAC	AAAGGACAGATTGTGTCGAC	1
GTAGGGACAAGTGTTGGCCA	GTAGTGACAAGTGTTGGCCA	1
GATATAATTCAACAAGAATT	CATCTAATTCAACAAGAATT	2
CCATCTAATTAAACAAGAAT	CCATCTAATTCAACAAGAAT	1
ATGTGGTCACGCTTTTCGTT	ATGTGGTCACGCTTTTCGTT	0
ATGTGGTCACGCTTTTCGTT	ATGTGGTCACGCTTTTCGTT	0
ATGTGGTCACGCTTTTCGTT	ATGTGGTCACGCTTTTCGTT	0
ATGTGGTCACGCTTTTCGTT	ATGTGGTCACGCTTTTCGTT	0
ACGAGTGTTGGCCACGGAAC	ACAAGTGTTGGCCACGGAAC	1
CGGTACATAACCTTTGGGCA	CTGTACATAACCTTCGGGCA	2
CATGTGGTCACGGTTCTCGT	CATGTGGTCACGCTTTTCGT	2
CCATCTAATTCAACATGAAT	CCATCTAATTCAACAAGAAT	1
ATAATTGTCTGCTAGTTGTA	ATAATGGTCTGCTAGTTGAA	2
AGTAGTGCAAATTAATTTAA	AGTAGTGCAAATAAATTTAA	1
GTAGTGACAAGTGTTGGTCA	GTAGTGACAAGTGTTGGCCA	1
ATGTGGTCACGTTTTTCGTT	ATGTGGTCACGCTTTTCGTT	1
GTTCCATGTGATCCGGATCA	GTTTCATGTGATCCGGATAA	2
ATGTGGTCACGCTTTTCTTT	ATGTGGTCACGCTTTTCGTT	1
AAAGGACAGATTGTGTCGGT	AAAGGACAGATTGTGTCGAC	2
TAACTCGATACCATTAAAAA	TAACTCGATACGATTAACAA	2
ATATTGGTCTGCTGGTTGAA	ATAATGGTCTGCTAGTTGAA	2
CAGTAGAGCAGATAAATTTA	CAGTAGTGCAAATAAATTTA	2
GCGTTCCCGTACATAACCTT	GCGTTCCTGTACATAACCTT	1
ATAATGGTCTGCTAGGTGAA	ATAATGGTCTGCTAGTTGAA	1
AAACGACAGATTGTGTCGAC	AAAGGACAGATTGTGTCGAC	1
GTTTCATGCGATCCGGATAA	GTTTCATGTGATCCGGATAA	1
CGTTGATGTACATAACCTTC	CGTTCCTGTACATAACCTTC	2
CATGTGGTCACGCTATTCAT	CATGTGGTCACGCTTTTCGT	2
CATGTGGTCAGGCTTTTCGT	CATGTGGTCACGCTTTTCGT	1
CAGTAGTGGAAATAAATTTA	CAGTAGTGCAAATAAATTTA	1
CATCTAATTCAACAACAATT	CATCTAATTCAACAAGAATT	1
ATGAGGTCACGCTTTTCGTT	ATGTGGTCACGCTTTTCGTT	1
TGGTTGTCTGGTACAAGGAA	TGGTTGTCTGGTAAAAGGAC	2
ATAATGGTTTGCTAGTTGAA	ATAATGGTCTGCTAGTTGAA	1
CATCTAATTCACCAAGAATT	CATCTAATTCAACAAGAATT	1
CAAACTCAAGATGGACCATG	CAAACTCAAGAAGGACCATG	1
TGGTTGTCTGGCAAAAGGAC	TGGTTGTCTGGTAAAAGGAC	1
TTGGAGTATTTTGTTGACAA	TTGGAGTATTTTGTTGATAA	1
CATCTCATTCACCCTCTCCA	CATCACCTTCACCCTCTCCA	2
CGGAACCATTTTCATCGTTG	CGGAACCATCTTCAACGTTG	2
GGTAATGGTTGTGTGGTAAA	GGTAATGGTTGTCTGGTAAA	1
TTTGATGTGATCCCGATAAC	TTTCATGTGATCCGGATAAC	2
GGAAAAGCGTTGAACACCAT	GGAAAAGCATTGAACACCAT	1
TTAACTCGATACAATTAACA	TTAACTCGATACGATTAACA	1
GTCGACAGGCTATGGTTGTC	GTCGACAGGTAATGGTTGTC	2
CGTTCCTGTACATAGCCGTC	CGTTCCTGTACATAACCTTC	2
CAGATTGTGTCGACCGGTAG	CAGATTGTGTCGACAGGTAA	2
GACTTCAGCACGCGTCTGGT	GACTTCAGCACGCGTCTTGT	1
CCGTCCATAACCTTCGGGCA	CTGTACATAACCTTCGGGCA	2
AGGACAGGCCCATCGCCAAT	AGGACAGGGCCATCGCCAAT	1
ACAAGTGTTAGCCACGGAAC	ACAAGTGTTGGCCACGGAAC	1
TGTTCCTGTACATAAGCTTC	CGTTCCTGTACATAACCTTC	2
TTTCATGTGATCCGGAAAAC	TTTCATGTGATCCGGATAAC	1
GTCGACATGTAAGGGTTGTC	GTCGACAGGTAATGGTTGTC	2
TTTCATGAGATGCGGATAAC	TTTCATGTGATCCGGATAAC	2
GGTAAAGGTTGTCTGGTAAA	GGTAATGGTTGTCTGGTAAA	1
TAACTAGATACGATCAACAA	TAACTCGATACGATTAACAA	2
ACAAGTGCTGGCCACGGCAC	ACAAGTGTTGGCCACGGAAC	2
ATGTGGTCGCGCTTCTCGTT	ATGTGGTCACGCTTTTCGTT	2
AGTAGGGCAAATAAATTTAA	AGTAGTGCAAATAAATTTAA	1
TCATGCCGTTTGATGGGATC	TCATGCCGTTTCATGTGATC	2
AACTTCAGCACGCGTCTTGC	GACTTCAGCACGCGTCTTGT	2
GTCTTCAGCACGCGTCTTGT	GACTTCAGCACGCGTCTTGT	1
GGAAACGGATTGAACACCAT	GGAAAAGCATTGAACACCAT	2
TGGTTTTCTGGTAAAAGGGC	TGGTTGTCTGGTAAAAGGAC	2
GGTAGTGGTTGCCTGGTAAA	GGTAATGGTTGTCTGGTAAA	2
TGGACAGGGCCATCGCCAAG	AGGACAGGGCCATCGCCAAT	2
GTGGACAGGTTATGGTTGTC	GTCGACAGGTAATGGTTGTC	2
TCTCATGTGATCCGGTTAAC	TTTCATGTGATCCGGATAAC	2
ATGTGGTCACGATTTTTGTT	ATGTGGTCACGCTTTTCGTT	2
CGGACAGGGCCATCGCCAAG	AGGACAGGGCCATCGCCAAT	2
CGTTCCTGCACATAACATTC	CGTTCCTGTACATAACCTTC	2
CGTTCCTGTAAATGACCTTC	CGTTCCTGTACATAACCTTC	2
CTGTACATAACCTTCAGGAA	CTGTACATAACCTTCGGGCA	2
ATGTGGTCACGCTTGTCGTT	ATGTGGTCACGCTTTTCGTT	1
TCATGCTGTTTCATGGGATC	TCATGCCGTTTCATGTGATC	2
TTTCATGAGATCCGGATAAA	TTTCATGTGATCCGGATAAC	2
CAGTAGTGCAAATAGATTTA	CAGTAGTGCAAATAAATTTA	1
AGGACAGGGTCATCGCCAAT	AGGACAGGGCCATCGCCAAT	1
CGTTCCTGAACATAACCCTC	CGTTCCTGTACATAACCTTC	2
ACAAGTGTTGCCCACGGAAC	ACAAGTGTTGGCCACGGAAC	1
TTAACTCGATACGATTATCA	TTAACTCGATACGATTAACA	1
GACTTCAGCGCGTGTCTTGT	GACTTCAGCACGCGTCTTGT	2
CGGTACATAACCTTCTGGCA	CTGTACATAACCTTCGGGCA	2
ACAAGCGTTGGCCACGGAAC	ACAAGTGTTGGCCACGGAAC	1
CGGAACCATCTTCAACGTAG	CGGAACCATCTTCAACGTTG	1
TCATGCCGTTTCATGTGATA	TCATGCCGTTTCATGTGATC	1
CGGAATCATCTTCAACTTTG	CGGAACCATCTTCAACGTTG	2
CTGTACATAACCTTCGGACA	CTGTACATAACCTTCGGGCA	1
CGTTCATGTACATAACCTGC	CGTTCCTGTACATAACCTTC	2
AAAAGTGTTAGCCACGGAAC	ACAAGTGTTGGCCACGGAAC	2
CAGTATTGCAAATAAATTTA	CAGTAGTGCAAATAAATTTA	1
GGTTGTCTGGTAAAAGTACA	GGTTGTCTGGTAAAAGGACA	1
TTGTCGTCACGCTTTTCGTT	ATGTGGTCACGCTTTTCGTT	2
ATAATGGTCTGCTATCTGAA	ATAATGGTCTGCTAGTTGAA	2
CAATCTCAAGAAGGACCATG	CAAACTCAAGAAGGACCATG	1
CAGTAGTGCAAATAAATATA	CAGTAGTGCAAATAAATTTA	1
GTTGTGACAAGTGTTGGCCA	GTAGTGACAAGTGTTGGCCA	1
GTCAGAGTAGTGACAAGAGT	GTCAGAGTAGTGACAAGTGT	1
CATCACCTTGACCCTCTCCA	CATCACCTTCACCCTCTCCA	1
AAAGGACACATTGTGTCGCC	AAAGGACAGATTGTGTCGAC	2
CAAACTGAAGAAGGACCATT	CAAACTCAAGAAGGACCATG	2
ACAAGTGTTGGCCACGCCAC	ACAAGTGTTGGCCACGGAAC	2
CGGAGCCATCTTCAACGTTG	CGGAACCATCTTCAACGTTG	1
TTTCGTTGCGATCTTTCGAC	TTTCGTTGGGATCTTTCGAA	2
ACAAGTGTTGGTCACGGAAC	ACAAGTGTTGGCCACGGAAC	1
AAGTAGTGCAAATAAAATTA	CAGTAGTGCAAATAAATTTA	2
TTAACTCGATACGACTAACA	TTAACTCGATACGATTAACA	1
TCGGAGTATTTGGTTGATAA	TTGGAGTATTTTGTTGATAA	2
CAGTAGTGCAAATAAATTTT	CAGTAGTGCAAATAAATTTA	1
CAAGCTCAAGAAGGTCCATG	CAAACTCAAGAAGGACCATG	2
TCACGCCGTTTCATGTGATC	TCATGCCGTTTCATGTGATC	1
GTTTGTCAGGTAAAAGGACA	GGTTGTCTGGTAAAAGGACA	2
GGTAATGGCTGTCAGGTAAA	GGTAATGGTTGTCTGGTAAA	2
GGTTGTCTAGTAAAAGGACA	GGTTGTCTGGTAAAAGGACA	1
GGTCGTCTGGTAAAAGGAGA	GGTTGTCTGGTAAAAGGACA	2
AGCAGTGCGAATAAATTTAA	AGTAGTGCAAATAAATTTAA	2
CAGCAGTTACGAACTCAACA	CAGCAGTTACAAACTCAAGA	2
CAAACTCCTGAAGGACCATG	CAAACTCAAGAAGGACCATG	2
CAGCAGTTACAAACTCAAGA	CAGCAGTTACAAACTCAAGA	0
CAGCAGTTACAAACTCAAGA	CAGCAGTTACAAACTCAAGA	0
CAGCAGTTACAAACTCAAGA	CAGCAGTTACAAACTCAAGA	0
CAGCAGTTACAAACTCAAGA	CAGCAGTTACAAACTCAAGA	0
ATAATGGTCTGCTAGTAGAA	ATAATGGTCTGCTAGTTGAA	1
TTTCGTTGGGATGTTTCGAA	TTTCGTTGGGATCTTTCGAA	1
GGAAAAGTATCGAACACCAT	GGAAAAGCATTGAACACCAT	2
CAGTAGTGCGAATAAATTTA	CAGTAGTGCAAATAAATTTA	1
AAACTCGATACGATTAACAA	TAACTCGATACGATTAACAA	1
CAGTACTGCATATAAATTTA	CAGTAGTGCAAATAAATTTA	2
GGTTGTCTGGTATAAGGACA	GGTTGTCTGGTAAAAGGACA	1
TAATTCCATACGATTAACAA	TAACTCGATACGATTAACAA	2
CTGTACATAACCTTCAGGCA	CTGTACATAACCTTCGGGCA	1
GTCCACAGGTAATGGGTGTC	GTCGACAGGTAATGGTTGTC	2
TTGGAGTATTATGTTGATAA	TTGGAGTATTTTGTTGATAA	1
ATAATGGTCTGCTACTTGAA	ATAATGGTCTGCTAGTTGAA	1
TAAACTCGATACGGTTAACA	TTAACTCGATACGATTAACA	2
TTCCGTTGGGATCTTTCAAA	TTTCGTTGGGATCTTTCGAA	2
TTGTGGTCACGGTTTTCGTT	ATGTGGTCACGCTTTTCGTT	2
CATCAGATACAAACTCAAGA	CAGCAGTTACAAACTCAAGA	2
TCAAGCCGTTTCATGCGATC	TCATGCCGTTTCATGTGATC	2
CAGCAGTTATAATCTCAAGA	CAGCAGTTACAAACTCAAGA	2
CAGCAGGTACAAACTCAAGA	CAGCAGTTACAAACTCAAGA	1
ATAATGGTCTGCCAGTTGTA	ATAATGGTCTGCTAGTTGAA	2
ATCGACAGGTAATGGTTGTC	GTCGACAGGTAATGGTTGTC	1
CCCAGAGTAGTGACAAGTGT	GTCAGAGTAGTGACAAGTGT	2
TTGGAGTATTTAGTTTATAA	TTGGAGTATTTTGTTGATAA	2
GCTTGTCTGGTAAAAGGACA	GGTTGTCTGGTAAAAGGACA	1
CGTTCCTGTACATAACCCTC	CGTTCCTGTACATAACCTTC	1
TTAACTCGCTACGATTAACA	TTAACTCGATACGATTAACA	1
GACTTCAGCGCTCGTCTTGT	GACTTCAGCACGCGTCTTGT	2
CTTCATGTGATCCTGATAAC	TTTCATGTGATCCGGATAAC	2
TGGATGTCTGGTAAAAGGAC	TGGTTGTCTGGTAAAAGGAC	1
TAACTGGATACGATTGACAA	TAACTCGATACGATTAACAA	2
AGGACAGGGCCAACGCCAAT	AGGACAGGGCCATCGCCAAT	1
CATCTCATTCAACAAGAATT	CATCTAATTCAACAAGAATT	1
GGAAAAGCTTTTAACACCAT	GGAAAAGCATTGAACACCAT	2
AGGACAGGTCCATCGGCAAT	AGGACAGGGCCATCGCCAAT	2
TATCACCTTCCCCCTCTCCA	CATCACCTTCACCCTCTCCA	2
CAGATTGTGTCGAGAGGTAA	CAGATTGTGTCGACAGGTAA	1
CATCACCTTCACCCCTTCCA	CATCACCTTCACCCTCTCCA	2
ATGTGGTCACTCTTATCGTT	ATGTGGTCACGCTTTTCGTT	2
CTGATTGTGTTGACAGGTAA	CAGATTGTGTCGACAGGTAA	2
TGACTCGATATGATTAACAA	TAACTCGATACGATTAACAA	2
GCGTTCATATACATAACCTT	GCGTTCCTGTACATAACCTT	2
CCCTCAAATTCAACAAGAAT	CCATCTAATTCAACAAGAAT	2
CGTTCCTGTACATAAACTTC	CGTTCCTGTACATAACCTTC	1
GCGTCCCTGTACATAACCTT	GCGTTCCTGTACATAACCTT	1
GGTTGTCTGGAAAAAGGCCA	GGTTGTCTGGTAAAAGGACA	2
GGTAATGGTTGTCTCGTAAA	GGTAATGGTTGTCTGGTAAA	1
GACTGCAGCACTCGTCTTGT	GACTTCAGCACGCGTCTTGT	2
CAAACTCAAGAAGGACCATC	CAAACTCAAGAAGGACCATG	1
GTCTTCCGCACGCGTCTTGT	GACTTCAGCACGCGTCTTGT	2
GTGTCATGTGTTCCGGATAA	GTTTCATGTGATCCGGATAA	2
TTGGAGTATTTTGTTGATGA	TTGGAGTATTTTGTTGATAA	1
AAACTCGATACGCTTAACAA	TAACTCGATACGATTAACAA	2
CGTTCCCGTACATAAACTTC	CGTTCCTGTACATAACCTTC	2
TTCGTGACAAGTGTTGGCCA	GTAGTGACAAGTGTTGGCCA	2
GGTTTTCTGGTAAACGGACA	GGTTGTCTGGTAAAAGGACA	2
CATCTACTTCAACAAGAATT	CATCTAATTCAACAAGAATT	1
GACTTCAGCACGCGTTTTGT	GACTTCAGCACGCGTCTTGT	1
CCATCTAATTCAAGTAGAAT	CCATCTAATTCAACAAGAAT	2
CATCTAATTTAACAAGAATT	CATCTAATTCAACAAGAATT	1
TAACTCGATAGGTTTAACAA	TAACTCGATACGATTAACAA	2
AGGACAGGGCCATTGCCAAT	AGGACAGGGCCATCGCCAAT	1
AATAGTGCAAATACATTTAA	AGTAGTGCAAATAAATTTAA	2
CAGATTGTGTCGACAGGTAT	CAGATTGTGTCGACAGGTAA	1
AATAACCTTCACCCTCTCCA	CATCACCTTCACCCTCTCCA	2
GTCAGAGTAGTGATAAGTAT	GTCAGAGTAGTGACAAGTGT	2
CATGTGGTCCCGCTTTTCGT	CATGTGGTCACGCTTTTCGT	1
GACTTCAGCACGCGTCCTGT	GACTTCAGCACGCGTCTTGT	1
TATCGTGGGGATCTTTCGAA	TTTCGTTGGGATCTTTCGAA	2
AGTAGTACAAATAAATTTAA	AGTAGTGCAAATAAATTTAA	1
GATTCATGTGATCTGGATAA	GTTTCATGTGATCCGGATAA	2
CACGCTCAAGAAGGACCATG	CAAACTCAAGAAGGACCATG	2
CTGTACATAACCTTCGGGCG	CTGTACATAACCTTCGGGCA	1
CAGCACTTACAAACTAAAGA	CAGCAGTTACAAACTCAAGA	2
GATAATGGTTGTCTGGTAAA	GGTAATGGTTGTCTGGTAAA	1
GTAGCGACAAGTGCTGGCCA	GTAGTGACAAGTGTTGGCCA	2
CATGTGGTCAAGCTTTTCGT	CATGTGGTCACGCTTTTCGT	1
CGGAACTATCCTCAACGTTG	CGGAACCATCTTCAACGTTG	2
GGTAATGGCTGTCTGGTAGA	GGTAATGGTTGTCTGGTAAA	2
TGGTTGTCTGGTAAAACGTC	TGGTTGTCTGGTAAAAGGAC	2
ATGACAGGGCCATCGCCAAT	AGGACAGGGCCATCGCCAAT	1
TCATGCCGTTTCAATTGATC	TCATGCCGTTTCATGTGATC	2
ATAATGGTCTGCTAATTGAC	ATAATGGTCTGCTAGTTGAA	2
GGAAAAGCATTGAAAACCGT	GGAAAAGCATTGAACACCAT	2
CAAACTCAAGAAGGACCTTG	CAAACTCAAGAAGGACCATG	1
TGGTTGTCTGGTAAAACGAC	TGGTTGTCTGGTAAAAGGAC	1
TGGTTGTCTGGTAAAAGGAG	TGGTTGTCTGGTAAAAGGAC	1
CAGCAGTTGCAAACTCAAGA	CAGCAGTTACAAACTCAAGA	1
GGTTGTCTGGCAAAAGGACA	GGTTGTCTGGTAAAAGGACA	1
TGGTTGTCTGGTTAAAGGAG	TGGTTGTCTGGTAAAAGGAC	2
TCACTTGATACGATTAACAA	TAACTCGATACGATTAACAA	2
CATGTGGTAACGCTTTTCGT	CATGTGGTCACGCTTTTCGT	1
CACCAGTTACAAACTTAAGA	CAGCAGTTACAAACTCAAGA	2
CATCTACTTAAACAAGAATT	CATCTAATTCAACAAGAATT	2
GTAGTGACAAGTGTCGGCTA	GTAGTGACAAGTGTTGGCCA	2
CGAAAAGCATTGAACACCAT	GGAAAAGCATTGAACACCAT	1
CTGTAAATAACCTTCGTGCA	CTGTACATAACCTTCGGGCA	2
CGTTCCTGTACATAACGTTC	CGTTCCTGTACATAACCTTC	1
GCGTTCCTGTACATAGCCTT	GCGTTCCTGTACATAACCTT	1
TAACTCGATACGATTAACTA	TAACTCGATACGATTAACAA	1
TTTCGTTGGGATATTGCGAA	TTTCGTTGGGATCTTTCGAA	2
GGTTGTCTGGTAAAAGGACA	GGTTGTCTGGTAAAAGGACA	0
GGTTGTCTGGTAAAAGGACA	GGTTGTCTGGTAAAAGGACA	0
GGTTGTCTGGTAAAAGGACA	GGTTGTCTGGTAAAAGGACA	0
GGTTGTCTGGTAAAAGGACA	GGTTGTCTGGTAAAAGGACA	0
CGTTCCTGTACATAACCTTT	CGTTCCTGTACATAACCTTC	1
ATGTCGTCACGCTTTTCTTT	ATGTGGTCACGCTTTTCGTT	2
TCATCCCGTTTCATGTGATC	TCATGCCGTTTCATGTGATC	1
CAAACTCAATAAGGACCATG	CAAACTCAAGAAGGACCATG	1
ATCATGGTCTGCTAGTTGAA	ATAATGGTCTGCTAGTTGAA	1
GTAATGACAAGTTTTGGCCA	GTAGTGACAAGTGTTGGCCA	2
CAAACTCAAGAAGGACCATT	CAAACTCAAGAAGGACCATG	1
GGATAAGCATTGAACACCAT	GGAAAAGCATTGAACACCAT	1
CATGTGGTGACGCTGTTCGT	CATGTGGTCACGCTTTTCGT	2
AAGTAGTGCAAAGAAATTTA	CAGTAGTGCAAATAAATTTA	2
CTGTACATAACCTTCGCGCT	CTGTACATAACCTTCGGGCA	2
TTGCGTTCGGATCTTTCGAA	TTTCGTTGGGATCTTTCGAA	2
AGGACAGGGCCATCTCCAAT	AGGACAGGGCCATCGCCAAT	1
GTAGTGACAAGTTTTGGCCA	GTAGTGACAAGTGTTGGCCA	1
GGTTGCCTGGTAGAAGGACA	GGTTGTCTGGTAAAAGGACA	2
TAACTCGATACGCTTAAGAA	TAACTCGATACGATTAACAA	2
TTGTAGTATTTTGTTGATAA	TTGGAGTATTTTGTTGATAA	1
ACAAGTGTTGGCCACGTGAC	ACAAGTGTTGGCCACGGAAC	2
CATCACCTTCCCCGTCTCCA	CATCACCTTCACCCTCTCCA	2
CGGAACCATCTTCAACGTTG	CGGAACCATCTTCAACGTTG	0
CGGAACCATCTTCAACGTTG	CGGAACCATCTTCAACGTTG	0
CGGAACCATCTTCAACGTTG	CGGAACCATCTTCAACGTTG	0
CGGAACCATCTTCAACGTTG	CGGAACCATCTTCAACGTTG	0
GTAGTGACAAGTGTTGGCCG	GTAGTGACAAGTGTTGGCCA	1
GAGTCGTGCAAATAAATTTA	CAGTAGTGCAAATAAATTTA	2
TAACTCGATACGATTAACGA	TAACTCGATACGATTAACAA	1
CGGACCCATCTCCAACGTTG	CGGAACCATCTTCAACGTTG	2
CATCACCTTCACACTCTCCA	CATCACCTTCACCCTCTCCA	1
TTTAGTTGGGATCTTTCGAA	TTTCGTTGGGATCTTTCGAA	1
GTTCCATGTGATCCGGATAA	GTTTCATGTGATCCGGATAA	1
CAGCAGTTACAAATTCAAGA	CAGCAGTTACAAACTCAAGA	1
CCATCTAATTCAACAATACT	CCATCTAATTCAACAAGAAT	2
CATCACCTTCACCCGCTCAA	CATCACCTTCACCCTCTCCA	2
GTAGAGACAAGTGTTGGCCA	GTAGTGACAAGTGTTGGCCA	1
GTCAGAGTAGTGACACGTGG	GTCAGAGTAGTGACAAGTGT	2
GGTTGTCTGGTAAAAGGAAA	GGTTGTCTGGTAAAAGGACA	1
GGAAAAGCAATGAACACCAT	GGAAAAGCATTGAACACCAT	1
AAGGCAGGGCCATCGCCAAT	AGGACAGGGCCATCGCCAAT	2
GGTTGTCCTGTAAAAGGACA	GGTTGTCTGGTAAAAGGACA	2
CAGCAGTTACAATCTCAAGA	CAGCAGTTACAAACTCAAGA	1
TGGTTGTCTGGTAAAAGGAA	TGGTTGTCTGGTAAAAGGAC	1
TTAACTCGATACGATTACCA	TTAACTCGATACGATTAACA	1
CAGTAGTGCAAGTATATTTA	CAGTAGTGCAAATAAATTTA	2
TGGTTGTCTGCTAAAAGGGC	TGGTTGTCTGGTAAAAGGAC	2
TTTCATGGGATCCGGATAGC	TTTCATGTGATCCGGATAAC	2
ATAATGGTCTGCCAGTTGAA	ATAATGGTCTGCTAGTTGAA	1
CCATCAAATTCAACAAGAAT	CCATCTAATTCAACAAGAAT	1
GCGTTCCTTTACATAACCTT	GCGTTCCTGTACATAACCTT	1
GACTTCAGGATGCGTCTTGT	GACTTCAGCACGCGTCTTGT	2
AGGACAGGGCCAGCGCCAAA	AGGACAGGGCCATCGCCAAT	2
CATCTAATTCAAGTAGAATT	CATCTAATTCAACAAGAATT	2
CAACTCGATACGATTGACAA	TAACTCGATACGATTAACAA	2
TTTCGTGGGGATCTGTCGAA	TTTCGTTGGGATCTTTCGAA	2
AGGACAGGGCCATCGCCCAG	AGGACAGGGCCATCGCCAAT	2
AGGAGAGAGCCATCGCCAAT	AGGACAGGGCCATCGCCAAT	2
GTCGGGAGGTAATGGTTGTC	GTCGACAGGTAATGGTTGTC	2
ATGTGGTCCCGCTTTTCTTT	ATGTGGTCACGCTTTTCGTT	2
TAACTCGATATGATTAACAA	TAACTCGATACGATTAACAA	1
AAAATGGTCTGTTAGTTGAA	ATAATGGTCTGCTAGTTGAA	2
CTTTACATAACCTTCGGGCA	CTGTACATAACCTTCGGGCA	1
CAGTAGTGCAAAGAAATTTA	CAGTAGTGCAAATAAATTTA	1
CCAACTCAAGACGGACCATG	CAAACTCAAGAAGGACCATG	2
CGCTCCTGCACATAACCTTC	CGTTCCTGTACATAACCTTC	2
CAAACTTAAGATGGACCATG	CAAACTCAAGAAGGACCATG	2
CGTTCCTGAACATAACCTAC	CGTTCCTGTACATAACCTTC	2
GGGTGTCTGGTGAAAGGACA	GGTTGTCTGGTAAAAGGACA	2
ACAAGTGTTGGCCAGGGAAC	ACAAGTGTTGGCCACGGAAC	1
CATCACCTTCACCCTTTCCA	CATCACCTTCACCCTCTCCA	1
CAAACTGTAGAAGGACCATG	CAAACTCAAGAAGGACCATG	2
CTAACTCGAGACGATTAACA	TTAACTCGATACGATTAACA	2
GGTTGTCTGGCAAAAGGATA	GGTTGTCTGGTAAAAGGACA	2
ACAAGTGTTGGCCACGGAGC	ACAAGTGTTGGCCACGGAAC	1
CAGTTCATAACCTTCGGGCA	CTGTACATAACCTTCGGGCA	2
GTTTCATGAGATCCGTATAA	GTTTCATGTGATCCGGATAA	2
GATCACCTTCACCCTCTCCC	CATCACCTTCACCCTCTCCA	2
CCATCCAATTCAACAAGGAT	CCATCTAATTCAACAAGAAT	2
TATAGTTGGGATCTTTCGAA	TTTCGTTGGGATCTTTCGAA	2
GCGTGCCTGTACATAACCGT	GCGTTCCTGTACATAACCTT	2
TTAAAGGTCTGCTAGTTGAA	ATAATGGTCTGCTAGTTGAA	2
GCGTTCCTGTACACAACCTT	GCGTTCCTGTACATAACCTT	1
ATAATGGTCTCCTAGGTGAA	ATAATGGTCTGCTAGTTGAA	2
ATGATGGTCTGCTAGTTGAA	ATAATGGTCTGCTAGTTGAA	1
TTGAAGTATTTTGTTGATAA	TTGGAGTATTTTGTTGATAA	1
CCATCTAATTCAACAAACAT	CCATCTAATTCAACAAGAAT	2
CAAACACAAGAAGGACCATG	CAAACTCAAGAAGGACCATG	1
CATCTTATTCAACAAGACTT	CATCTAATTCAACAAGAATT	2
CATCACCTGCACCCTCTCCA	CATCACCTTCACCCTCTCCA	1
GTAGTGACAAGTATTGGCCA	GTAGTGACAAGTGTTGGCCA	1
CAGTAGTGACAAACTCAAGA	CAGCAGTTACAAACTCAAGA	2
CATCTAATTCAACTATAATT	CATCTAATTCAACAAGAATT	2
TAACTCGATACGATTAAAAA	TAACTCGATACGATTAACAA	1
AGGACAGGCACATCGCCAAT	AGGACAGGGCCATCGCCAAT	2
TATCGTTGGGATCTTTCGAA	TTTCGTTGGGATCTTTCGAA	1
GCGTTCCTGTAGATACCCTT	GCGTTCCTGTACATAACCTT	2
GCGTTCCTGTACTTAACCTT	GCGTTCCTGTACATAACCTT	1
AGAATGGTCTGCTAGTTCAA	ATAATGGTCTGCTAGTTGAA	2
CAGTAGTGCGACTAAATTTA	CAGTAGTGCAAATAAATTTA	2
GAGCACTTACAAACTCAAGA	CAGCAGTTACAAACTCAAGA	2
GTAGTGACAAGTGTTCGCCA	GTAGTGACAAGTGTTGGCCA	1
CGGTACATAACCTTCGGGCA	CTGTACATAACCTTCGGGCA	1
CGTTCCTGTAGATAACCTTC	CGTTCCTGTACATAACCTTC	1
GACTTCAGCACGCGACTTGT	GACTTCAGCACGCGTCTTGT	1
TTGGAGTATTTAGTTGATAA	TTGGAGTATTTTGTTGATAA	1
ACAAGTCTTGGCCAAGGAAC	ACAAGTGTTGGCCACGGAAC	2
ATGTGGTCAACCTTTTCGTT	ATGTGGTCACGCTTTTCGTT	2
GTCAGAGTAGTGACGAGTGT	GTCAGAGTAGTGACAAGTGT	1
ATTATGGTCTGCTAGTTGAA	ATAATGGTCTGCTAGTTGAA	1
